کرمانشاه,05,576861,1952434,964419,988015,2,00
اسلام آبادغرب,0501,40911,140876,69507,71369,3,05
کرمانشاه,0502,323291,1083833,535507,548326,3,05
پاوه,0503,18471,60431,29972,30459,3,05
سرپل ذهاب,0504,23696,85342,42468,42874,3,05
سنقر,0505,25554,81661,40476,41185,3,05
قصرشيرين,0506,6903,23929,11182,12747,3,05
کنگاور,0507,23253,76216,37799,38417,3,05
گيلانغرب,0508,16570,57007,28177,28830,3,05
جوانرود,0509,20592,75169,36875,38294,3,05
صحنه,0510,21788,70757,35042,35715,3,05
هرسين,0511,22506,78350,38806,39544,3,05
ثلاث باباجاني,0512,9270,35219,17231,17988,3,05
دالاهو,0513,10266,35987,18100,17887,3,05
روانسر,0514,13790,47657,23277,24380,3,05
ده کريشه,0501047069,156,598,272,326,4,0501
مزرعه قلندرلکي,0501047074,0,0,0,0,4,0501
سياه خور,0501047135,140,490,242,248,4,0501
کريم حاصله عليا,0501047149,4,11,7,4,4,0501
لريني اجوداني,0501047156,69,245,116,129,4,0501
دلو حسن آباد,0501047068,139,453,240,213,4,0501
زينل خاني,0501047070,0,0,0,0,4,0501
فرح خاني,0501047071,46,159,83,76,4,0501
محمدعلي خاني,0501047072,112,359,165,194,4,0501
مزرعه نساردکاکين,0501047075,0,0,0,0,4,0501
کريم حاصله سفلي,0501047150,20,72,39,33,4,0501
مزرعه محمدعلي خاني,0501047531,0,0,0,0,4,0501
حسن اباد,0501047066,276,913,466,447,4,0501
مزرعه تپه ميمونه,0501047073,0,0,0,0,4,0501
مزرعه ميان رود,0501047076,0,0,0,0,4,0501
انباروزارت راه,0501047063,0,0,0,0,4,0501
تنگ شوهان سفلي,0501047064,129,455,237,218,4,0501
تنگ شوهان عليا,0501047065,160,514,253,261,4,0501
دارخورحسن اباد,0501047067,61,203,106,97,4,0501
باقرابادسفلي,0501047520,158,607,309,298,4,0501
باقرابادعليا,0501047521,160,564,284,280,4,0501
کمره عليا,0501047570,82,302,144,158,4,0501
شاهيني,0501047562,92,357,164,193,4,0501
سراب شاهيني,0501047559,45,168,83,85,4,0501
شيت کمرزرد,0501047564,61,232,114,118,4,0501
انجيرک,0501352895,212,790,377,413,4,0501
کمرزرد,0501047567,172,618,311,307,4,0501
گرگي مندرک,0501047571,115,415,220,195,4,0501
مندرک,0501047573,66,254,131,123,4,0501
توه خشکه,0502049022,11,30,17,13,4,0502
چشمه گچ,0502049027,131,477,239,238,4,0502
ده عباسيان,0502049038,27,73,35,38,4,0502
سه چکان مله شاهي,0502049048,65,238,114,124,4,0502
قاپقوي,0502049053,78,289,125,164,4,0502
انجيرک,0502049014,27,90,44,46,4,0502
چنارسفلي,0502049028,11,37,16,21,4,0502
دره بادام سفلي,0502049034,7,20,8,12,4,0502
دره بادام عليا,0502049035,7,35,20,15,4,0502
دول معصوم,0502049037,15,54,25,29,4,0502
زنيلان عليا,0502049040,28,104,55,49,4,0502
زنيلان سفلي,0502049041,27,99,55,44,4,0502
سراييلان سرقلعه,0502049045,26,108,45,63,4,0502
سگري,0502049046,0,0,0,0,4,0502
گاومره,0502049059,29,98,41,57,4,0502
گلستان,0502049061,44,148,68,80,4,0502
فريادرس,0502049066,5,15,8,7,4,0502
ملک حسن ياريجان,0502049068,11,34,15,19,4,0502
نوراز,0502049072,4,18,10,8,4,0502
ياريجان سفلي,0502049075,9,33,15,18,4,0502
ياريجان عليا,0502049076,29,92,44,48,4,0502
تازه ابادسراييلان,0502049020,23,82,42,40,4,0502
چشمه کبودچنار,0502049024,25,81,36,45,4,0502
چنارعليا,0502049029,12,45,17,28,4,0502
چناروسطي,0502049030,25,87,31,56,4,0502
دوردشت,0502049036,60,188,96,92,4,0502
ده موسي,0502049039,45,146,70,76,4,0502
بان رمضان,0502049015,21,82,38,44,4,0502
پرگلي سفلي,0502049017,9,27,14,13,4,0502
پرگلي عليا,0502049018,18,76,43,33,4,0502
چشمه سرخ قبربابا,0502049023,10,44,24,20,4,0502
چشمه کبودعليا,0502049026,9,33,16,17,4,0502
دارونه,0502049033,5,16,5,11,4,0502
سراب کريان,0502049042,26,83,44,39,4,0502
سرزل,0502049044,28,116,65,51,4,0502
سولاب,0502049047,0,0,0,0,4,0502
شاه ولي,0502049049,0,0,0,0,4,0502
شجاع,0502049050,4,18,6,12,4,0502
طويله سفلي,0502049051,0,0,0,0,4,0502
طويله عليا,0502049052,6,22,12,10,4,0502
قلعه سرخ,0502049054,12,53,20,33,4,0502
کريان,0502049055,20,72,34,38,4,0502
کلک سفلي,0502049056,0,0,0,0,4,0502
کلک عليا,0502049057,0,0,0,0,4,0502
گله زرد,0502049058,4,11,6,5,4,0502
گراب,0502049060,0,0,0,0,4,0502
گلان,0502049063,0,0,0,0,4,0502
لاله بگ,0502049064,5,18,5,13,4,0502
مزرعه دهران,0502049067,0,0,0,0,4,0502
ميانرود,0502049070,7,28,12,16,4,0502
ميرحسن,0502049071,33,116,64,52,4,0502
ورگچگه زيد علي,0502049074,0,0,0,0,4,0502
ملک زيد قلعه چهر,0502351790,0,0,0,0,4,0502
بربلوطستان پلکانه,0502049016,15,55,26,29,4,0502
تازه ابادخليفه,0502049019,0,0,0,0,4,0502
تلل,0502049021,45,167,80,87,4,0502
چشمه کبودسفلي,0502049025,6,32,14,18,4,0502
خوبياران سفلي,0502049031,15,63,26,37,4,0502
خوبياران عليا,0502049032,64,239,107,132,4,0502
سرجوب,0502049043,60,230,115,115,4,0502
گليانه علي باقر,0502049062,78,288,151,137,4,0502
مارخور,0502049065,4,18,7,11,4,0502
مي مي,0502351791,0,0,0,0,4,0502
خرس ابادبزرگ,0502048488,28,110,49,61,4,0502
خرس اباد آقا جعفري,0502048489,23,75,34,41,4,0502
خرس ابادکوچک,0502048490,0,0,0,0,4,0502
داردرفش ابراهيم بيگي,0502048494,23,80,45,35,4,0502
داردرفش خانم آباد,0502048495,15,53,25,28,4,0502
داردرفش سيدکريم,0502048496,22,73,32,41,4,0502
داردرفش فرج اله بيگي,0502048497,6,30,14,16,4,0502
داردرفش قلعه,0502048498,47,147,67,80,4,0502
داردرفش محمدامين ميرزا,0502048499,59,212,103,109,4,0502
ده قاسم,0502048505,25,89,48,41,4,0502
قزقبري ابراهيم,0502048526,21,80,44,36,4,0502
قزقبري بهادر,0502048527,9,26,13,13,4,0502
قزقبري دکترحبيب,0502048528,23,72,33,39,4,0502
قزقبري جهان بخش,0502048529,9,30,16,14,4,0502
گلالي جديد,0502048544,16,56,26,30,4,0502
قزقنبري رشيد علي,0502350219,12,34,13,21,4,0502
پتي اباد,0502048464,12,46,21,25,4,0502
تنوردول,0502048476,64,219,112,107,4,0502
سفيدچقاسرکن,0502048514,0,0,0,0,4,0502
شهرک سراب نيلوفر,0502048521,271,919,446,473,4,0502
کوربلاغ دو,0502048537,28,104,48,56,4,0502
کوربلاغ يک,0502048538,30,99,48,51,4,0502
کهريزکوربلاغ,0502048540,27,99,48,51,4,0502
گلالي,0502048543,48,169,81,88,4,0502
سرکن,0502048556,17,50,24,26,4,0502
مورچي,0502048561,4,18,10,8,4,0502
ويس احمد,0502048569,38,140,64,76,4,0502
کوسه وند,0502048575,47,127,59,68,4,0502
تازه ابادمورچي,0502350230,25,75,35,40,4,0502
پادگان شهيد رجايي,0502351800,15,2229,28,2201,4,0502
چقازرد,0502048483,71,231,108,123,4,0502
چقاسفيد,0502048484,11,45,23,22,4,0502
چقاقاسم,0502048485,39,129,59,70,4,0502
ريزوند,0502048507,38,121,53,68,4,0502
سراب نيلوفر,0502048512,112,378,193,185,4,0502
سفيدچقا,0502048513,55,188,92,96,4,0502
قلعه کهنه,0502048530,0,0,0,0,4,0502
گرگه چقا,0502048542,6,18,8,10,4,0502
مزرعه حسن اباد,0502048552,0,0,0,0,4,0502
ملک خطابي,0502048560,77,261,126,135,4,0502
تپه کبود,0502350234,0,0,0,0,4,0502
مزرعه کتيرايي,0502351799,0,0,0,0,4,0502
مزرعه ده زکي,0502351802,0,0,0,0,4,0502
باباجان پاليزي,0502048460,123,407,189,218,4,0502
چقاکبود,0502048486,27,96,50,46,4,0502
دايي چي,0502048500,47,155,71,84,4,0502
شاهيني,0502048520,97,344,165,179,4,0502
قره تپه,0502048525,25,89,41,48,4,0502
مهدي پور,0502048562,8,33,13,20,4,0502
يلوه سفلي,0502048572,15,50,26,24,4,0502
يلوه عليا,0502048573,18,57,30,27,4,0502
حسين اباد,0502048487,71,246,119,127,4,0502
دوستوند,0502048503,77,265,126,139,4,0502
سراب خشکه سفلي,0502048509,23,76,38,38,4,0502
سراب خشکه عليا,0502048510,30,103,57,46,4,0502
گراوند,0502048541,116,401,200,201,4,0502
نظرابادسفلي,0502048565,0,0,0,0,4,0502
نظر آباد,0502048566,4,15,8,7,4,0502
عمرمل,0502048523,81,290,135,155,4,0502
کهريز,0502048539,123,432,216,216,4,0502
مزرعه قلعه کهنه کهريز,0502350265,18,70,35,35,4,0502
سياه کمر,0502048518,241,959,467,492,4,0502
پتي اباد,0502049753,35,116,66,50,4,0502
جوره,0502049764,34,119,63,56,4,0502
چقازردباغي,0502049776,14,47,21,26,4,0502
دوچقاي,0502049797,30,99,48,51,4,0502
رحيم اباد سفلي,0502049811,39,127,64,63,4,0502
رحيم اباد عليا,0502049812,44,157,67,90,4,0502
سه تپه,0502049820,24,85,38,47,4,0502
سه چقا,0502049821,95,330,154,176,4,0502
عباس ابادسه چقا,0502049838,51,159,78,81,4,0502
عزيزاباد,0502049839,0,0,0,0,4,0502
کله سواري,0502049861,23,86,35,51,4,0502
تازه ابادناميوند,0502049758,26,87,45,42,4,0502
چقاحسين,0502049774,27,88,53,35,4,0502
شرف,0502049831,20,73,38,35,4,0502
قلعه داراب خان,0502049842,145,494,242,252,4,0502
ناميوندسفلي,0502049896,35,124,51,73,4,0502
ناميوندعليا,0502049897,93,306,147,159,4,0502
ناميوندوسطي,0502049898,0,0,0,0,4,0502
بندراباد,0502049751,8,29,17,12,4,0502
پادگان شهيدرجايي,0502049752,0,0,0,0,4,0502
چقابلک عليرضا,0502049770,61,230,108,122,4,0502
چقابهار,0502049773,35,122,55,67,4,0502
حسين اباد,0502049787,14,51,24,27,4,0502
ربع,0502049810,0,0,0,0,4,0502
علي ابادسفلي,0502049840,17,58,29,29,4,0502
کنگربان سفلي,0502049864,63,221,115,106,4,0502
کنگربان عليا,0502049865,46,146,71,75,4,0502
کنگربان وسطي,0502049866,17,53,26,27,4,0502
ملازمان,0502049891,53,179,80,99,4,0502
والي اباد,0502049901,0,0,0,0,4,0502
يکدانگي,0502049902,0,0,0,0,4,0502
چقانرگس,0502049780,169,592,288,304,4,0502
چقانقدعلي,0502049781,38,126,65,61,4,0502
سنگتراش,0502049818,80,294,133,161,4,0502
قوچمي,0502049851,0,0,0,0,4,0502
چقاکبود,0502350002,43,136,76,60,4,0502
بان گنجاب,0502049746,67,236,106,130,4,0502
بندبلوط,0502049750,14,49,24,25,4,0502
خانه بيگي,0502049788,13,39,19,20,4,0502
ده پير,0502049801,31,97,52,45,4,0502
سرتپه,0502049817,18,65,34,31,4,0502
کاشنبه چهاردانگي,0502049858,42,161,81,80,4,0502
کاشنبه سفلي,0502049859,56,194,91,103,4,0502
کاشنبه لک,0502049860,41,130,66,64,4,0502
گوهراباد,0502049869,68,265,125,140,4,0502
ده سفيد,0502049802,34,114,54,60,4,0502
جعفراباد,0502047257,33,119,59,60,4,0502
چقاالهي,0502047259,38,127,59,68,4,0502
حسين اباد,0502047272,30,107,50,57,4,0502
ده اعظم,0502047284,0,0,0,0,4,0502
شرفوند,0502047301,53,216,102,114,4,0502
صفراباد,0502047305,12,42,23,19,4,0502
فخري اباد,0502047311,64,220,107,113,4,0502
قلعه گلينه سفلي,0502047318,53,167,82,85,4,0502
قلعه گلينه عليا,0502047319,26,80,42,38,4,0502
گندمبان سفلي,0502047340,8,28,13,15,4,0502
گندمبان عليا,0502047341,5,18,6,12,4,0502
چقاکبودسفلي,0502047264,27,99,49,50,4,0502
چقاکبودعليا,0502047265,31,126,59,67,4,0502
چگني سفلي,0502047267,37,136,63,73,4,0502
چگني عليا,0502047268,36,124,65,59,4,0502
خورنه سفلي,0502047274,50,179,86,93,4,0502
خورنه عليا,0502047275,78,290,129,161,4,0502
سربر,0502047297,27,94,45,49,4,0502
سربرجديد,0502350040,10,33,19,14,4,0502
تازه ابادسراب تيران,0502047249,28,101,50,51,4,0502
تپه حسينخان,0502047251,29,101,43,58,4,0502
چقاخزان,0502047260,64,235,115,120,4,0502
حاجي اباد نيلاوره,0502047270,0,0,0,0,4,0502
داياراسدخان,0502047279,22,69,34,35,4,0502
سياه سياه دايار,0502047299,32,111,50,61,4,0502
قلعه اصغرخان,0502047313,4,11,4,7,4,0502
قيسوند,0502047322,33,132,65,67,4,0502
مزرعه سراب تيران,0502047348,0,0,0,0,4,0502
نيلاوره سفلي,0502047368,37,112,51,61,4,0502
نيلاوره عليا,0502047369,15,52,24,28,4,0502
ياوري دايار,0502047374,22,69,31,38,4,0502
باباکوسه سفلي,0502046810,26,87,39,48,4,0502
باباکوسه عليا,0502046811,27,82,37,45,4,0502
کرکره,0502046897,24,93,50,43,4,0502
ونه رنگينه,0502046922,35,129,60,69,4,0502
پل هواس,0502047245,23,97,51,46,4,0502
قلعه سليمان خان,0502047316,34,109,54,55,4,0502
خوره زردي,0502047350,11,47,18,29,4,0502
نظرگاه,0502047363,17,78,37,41,4,0502
نوروزاباد,0502047364,16,71,33,38,4,0502
هفتچشمه,0502047372,72,288,140,148,4,0502
بندار,0502047241,61,189,91,98,4,0502
درويش بيگه,0502047280,17,66,28,38,4,0502
دو کنعان,0502047282,0,0,0,0,4,0502
سالاراباد,0502047293,25,82,40,42,4,0502
سايه وند,0502047294,0,0,0,0,4,0502
مله صيفور,0502047300,7,33,16,17,4,0502
شيخ مصطفي,0502047304,25,63,31,32,4,0502
عباس ابادکل کل,0502047306,47,194,85,109,4,0502
علي حسن سفلي,0502047307,0,0,0,0,4,0502
علي حسن عليا,0502047308,14,59,27,32,4,0502
علي حسن وسطي,0502047309,10,28,12,16,4,0502
کره ال,0502047326,0,0,0,0,4,0502
کورپه,0502047329,8,28,14,14,4,0502
گلدره سفلي,0502047335,10,37,20,17,4,0502
گلدره عليا,0502047336,5,21,12,9,4,0502
لردستجه,0502047342,0,0,0,0,4,0502
کمره,0502047354,0,0,0,0,4,0502
مله بگلر,0502047356,32,109,58,51,4,0502
سبزعلي خان,0502047376,31,107,54,53,4,0502
بابان سردارقاسم خان,0502047236,74,250,113,137,4,0502
بابان ياورعزيزي,0502047237,140,490,239,251,4,0502
تازه اباد,0502047247,28,96,49,47,4,0502
تپه لله,0502047254,19,69,37,32,4,0502
سراب تيران,0502047296,47,162,77,85,4,0502
مزرعه صفر آباد ملوک خانم,0502047353,0,0,0,0,4,0502
ازره محمدخان,0502047231,11,37,21,16,4,0502
ازره مکرمي,0502047232,14,49,23,26,4,0502
بوربور,0502047242,69,261,138,123,4,0502
چقا رضا,0502047261,23,74,39,35,4,0502
قلعه گلينه وسطي,0502047320,0,0,0,0,4,0502
قليج خاني,0502047321,62,227,108,119,4,0502
گاول,0502047331,34,125,58,67,4,0502
گلودره,0502047338,40,141,62,79,4,0502
ميرعزيزي قديم,0502047358,53,186,90,96,4,0502
مزرعه گلالي,0502350010,0,0,0,0,4,0502
ولي اباد مخروبه,0502350014,0,0,0,0,4,0502
باباها,0502047238,24,79,38,41,4,0502
چقاگنوژ,0502047266,46,166,91,75,4,0502
چلبي,0502047269,5,14,6,8,4,0502
خالوان,0502047273,17,57,29,28,4,0502
ده ابراهيم,0502047283,0,0,0,0,4,0502
ده باغ,0502047285,6,17,7,10,4,0502
ده نمام,0502047289,5,19,6,13,4,0502
قباق تپه,0502047312,38,124,57,67,4,0502
کاکيها,0502047323,12,25,14,11,4,0502
مريواني کاکيها,0502047346,34,111,51,60,4,0502
سرخه بان,0502047352,0,0,0,0,4,0502
نيم دانگي,0502047367,14,45,25,20,4,0502
شوراباد,0502049835,24,94,47,47,4,0502
دولتيار,0502048733,54,159,79,80,4,0502
قلوزجديد,0502048773,6,15,10,5,4,0502
بهرام اباد,0502048702,74,250,122,128,4,0502
سلطانقلي,0502048753,27,94,41,53,4,0502
سورني سفلي,0502048756,76,275,146,129,4,0502
سورني عليا,0502048757,112,370,178,192,4,0502
قلوز,0502048772,33,124,63,61,4,0502
چشمه کبود,0502048720,188,644,315,329,4,0502
سالاراباد,0502048745,148,497,240,257,4,0502
رازيان,0502048736,179,635,321,314,4,0502
باتمان,0502353147,141,456,230,226,4,0502
ده خراني,0502353148,37,128,61,67,4,0502
چوب تاشان,0502048722,49,168,85,83,4,0502
گنداب,0502351680,71,259,130,129,4,0502
قيسوند,0502048775,142,528,270,258,4,0502
کمره گره,0502048787,186,674,330,344,4,0502
قلعه,0502352905,315,1130,545,585,4,0502
عبدالملکي,0502050111,16,55,29,26,4,0502
قره ويس,0502050117,0,0,0,0,4,0502
کلوچه,0502050125,119,437,203,234,4,0502
گرگان,0502050127,130,456,219,237,4,0502
پيرمزد,0502050074,18,59,28,31,4,0502
دارشادمان,0502050089,103,385,185,200,4,0502
مزرعه خورمگسان,0502050139,0,0,0,0,4,0502
هجوم اباد,0502050150,53,179,90,89,4,0502
تازه ابادمرکزي,0503051783,19,67,32,35,4,0503
دره بيان,0503051788,205,703,340,363,4,0503
بندره,0503051782,50,161,80,81,4,0503
سرکران,0503051792,70,238,122,116,4,0503
نسمه,0503051801,186,626,314,312,4,0503
الياس احمد,0504052011,112,498,242,256,4,0504
الياسي صالح مطاعي,0504052012,33,126,64,62,4,0504
انجيربان اواره علي,0504052013,6,25,11,14,4,0504
پيرميکاييل,0504052015,10,43,19,24,4,0504
چناره کاکه حسن,0504052019,0,0,0,0,4,0504
چناره مصطفي,0504052020,0,0,0,0,4,0504
سرآواره والي نظري,0504052029,17,68,37,31,4,0504
کرکوله مرادعلي,0504052039,0,0,0,0,4,0504
مجتمع باني هوان,0504052043,150,624,310,314,4,0504
مله رولان,0504052044,34,141,75,66,4,0504
ميولي دارابخان,0504052046,0,0,0,0,4,0504
ميولي سفلي,0504052047,58,224,112,112,4,0504
تل خلوتي قادررحمان,0504052016,6,32,17,15,4,0504
دنگي عباس داره زرد,0504052022,15,63,28,35,4,0504
دنگي علي بيگ,0504052023,22,82,32,50,4,0504
دنگي کاک عبدالله,0504052024,30,128,62,66,4,0504
دول درازمراد,0504052025,0,0,0,0,4,0504
سراواره والي نجفي,0504052028,32,109,52,57,4,0504
طلسم شهباز,0504052030,41,219,113,106,4,0504
فرمايشه اله نظر,0504052032,43,195,94,101,4,0504
قلعه کوه خسرو,0504052033,9,50,27,23,4,0504
قلعه گل علي اقا,0504052034,0,0,0,0,4,0504
قالودره,0504052035,14,61,33,28,4,0504
کفروباوکه,0504052036,18,99,48,51,4,0504
گورجوي رشيد,0504052040,0,0,0,0,4,0504
گوري زردالهي,0504052041,4,17,7,10,4,0504
مله کرمينه,0504052045,0,0,0,0,4,0504
دار زرد طهماسب,0504052049,5,34,17,17,4,0504
بزميراباد,0504052014,282,1111,546,565,4,0504
مزرعه داره زرديارعلي,0504052021,0,0,0,0,4,0504
فرج امام,0504052031,24,94,36,58,4,0504
مرشاعر,0504052050,8,22,12,10,4,0504
جنان,0504052017,9,37,18,19,4,0504
جوانميري,0504052018,97,456,208,248,4,0504
ده سفيد,0504052026,4,20,10,10,4,0504
دنکي رمضان,0504052027,167,706,362,344,4,0504
کفروسلمان,0504052037,41,172,88,84,4,0504
مزرعه کليله کاچي,0504052038,0,0,0,0,4,0504
ميولي شيرخان,0504052048,28,113,53,60,4,0504
انزل,0504052224,75,260,125,135,4,0504
کل داود,0504052250,23,80,46,34,4,0504
تنگ اسماعيل,0504052229,85,292,138,154,4,0504
داربلوط,0504052230,104,359,183,176,4,0504
لواساني,0504052254,56,180,91,89,4,0504
دارتوت,0504052231,172,563,267,296,4,0504
عثمان,0504052242,43,158,68,90,4,0504
قلعه سفيد سفلي,0504052244,47,148,79,69,4,0504
قلعه سفيدعليا,0504052246,41,140,77,63,4,0504
ترک ويس,0504052228,80,252,136,116,4,0504
دوازده امام,0504052232,211,767,373,394,4,0504
دولنگان سفلي,0504052233,93,310,157,153,4,0504
دولنگان عليا,0504052234,97,308,151,157,4,0504
قلعه شيخ حسن,0504052245,64,215,107,108,4,0504
کنار,0504351128,8,21,11,10,4,0504
طايفه مصطفي,0504351129,16,54,25,29,4,0504
اسياب قرمز,0504052223,49,144,69,75,4,0504
تپه عظيمه,0504052227,49,166,83,83,4,0504
قيطک,0504052248,89,292,137,155,4,0504
نوده,0504052258,80,243,126,117,4,0504
نهالستان انزل,0504052259,0,0,0,0,4,0504
مشکنار,0504351127,99,339,173,166,4,0504
قلعه فرهادخان,0505052389,135,432,212,220,4,0505
تپه رش,0505052347,39,120,56,64,4,0505
ده الياس,0505052369,37,134,70,64,4,0505
ده حمزه,0505052370,23,83,44,39,4,0505
ده نو,0505052372,27,92,40,52,4,0505
سرسگاز,0505052387,87,285,145,140,4,0505
کلبي اباد,0505052410,64,166,91,75,4,0505
مارانگاز,0505052382,223,704,360,344,4,0505
قره تپه,0505052388,94,295,155,140,4,0505
اب باريک عليا,0505052332,58,189,91,98,4,0505
اب باريک وسطي,0505052333,0,0,0,0,4,0505
افريانج,0505052336,14,37,18,19,4,0505
تقويت راديووتلويزيون,0505052348,0,0,0,0,4,0505
يارگله,0505052349,26,89,43,46,4,0505
جان احمد,0505052350,8,21,11,10,4,0505
پلنگين,0505052383,20,71,32,39,4,0505
علي اباديوسفي,0505052386,42,128,60,68,4,0505
کمراباد,0505052394,0,0,0,0,4,0505
کوچکينه,0505052396,84,247,132,115,4,0505
اردوگاه شهيدرجايي,0505351934,0,0,0,0,4,0505
چشمه سفيد,0505052523,52,173,85,88,4,0505
چفدر,0505052529,49,159,74,85,4,0505
حسن ابادگويجه,0505052535,4,6,2,4,4,0505
هفت اشيان,0505052566,106,361,182,179,4,0505
ده خداداد,0505052545,44,144,72,72,4,0505
زاغان سفلي,0505052551,71,236,116,120,4,0505
زاغان عليا,0505052552,69,225,109,116,4,0505
سايه کرعليا,0505052554,54,159,81,78,4,0505
سفيدزنگول,0505052557,12,37,16,21,4,0505
سلطانيه حاجي اباد,0505052559,8,24,12,12,4,0505
قلعه جبرييل,0505052569,13,41,25,16,4,0505
گل سرخه,0505052586,80,257,129,128,4,0505
گويجه,0505052587,0,0,0,0,4,0505
ايينه جوب,0505052494,17,40,24,16,4,0505
اگاه عليا,0505052499,102,320,159,161,4,0505
الياسان اميري,0505052502,31,101,49,52,4,0505
بورکه,0505052510,16,45,19,26,4,0505
حيدراباد,0505052537,21,60,25,35,4,0505
سايه کرسفلي,0505052553,63,181,91,90,4,0505
گل تپه,0505052585,0,0,0,0,4,0505
اسديه,0505052590,0,0,0,0,4,0505
نصرت اباد,0505052596,23,83,34,49,4,0505
ورداران,0505052597,7,21,11,10,4,0505
خليفه باپير,0505048730,20,63,35,28,4,0505
اسياب جوب,0505052497,13,49,22,27,4,0505
اميرعمران,0505052500,75,265,136,129,4,0505
المادين,0505052501,5,25,13,12,4,0505
جانعلي,0505052515,16,48,21,27,4,0505
خسروابادامجدي,0505052538,53,155,80,75,4,0505
ريگ جوب,0505052550,17,56,26,30,4,0505
کله پا,0505052579,26,85,40,45,4,0505
نفت شهر,0506351951,6,184,0,184,4,0506
چقاامان,0506352073,0,0,0,0,4,0506
کله جوب,0506352074,0,0,0,0,4,0506
چشمه مکي تاريوند,0506352075,0,0,0,0,4,0506
ني پهن,0506352077,0,0,0,0,4,0506
ممردو,0506352078,0,0,0,0,4,0506
گزين,0506352079,0,0,0,0,4,0506
ملاجعفر,0506352080,0,0,0,0,4,0506
ممريک,0506352082,0,0,0,0,4,0506
دارويس علي,0506352084,0,0,0,0,4,0506
شتران,0506352086,0,0,0,0,4,0506
ممرسه,0506352928,6,13,4,9,4,0506
پاسگاه نيروي انتظامي قلعه جوق,0506353055,0,0,0,0,4,0506
پاسگاه انتظامي سان و پا,0506353060,0,0,0,0,4,0506
پاسگاه انتظامي سلمان کشته,0506353062,0,0,0,0,4,0506
پاسگاه انتظامي چقا شيرگه,0506353063,0,0,0,0,4,0506
پاسگاه انتظامي سه تپان,0506353064,0,0,0,0,4,0506
پاسگاه انتظامي گمرک نو,0506353065,0,0,0,0,4,0506
پاسگاه انتظامي چقا حمام,0506353066,0,0,0,0,4,0506
پاسگاه انتظامي حيدر اباد,0506353067,0,0,0,0,4,0506
دواب سومار,0506353068,0,0,0,0,4,0506
پاسگاه نيروي انتظامي تپه گل,0506353069,0,0,0,0,4,0506
پاسگاه انتظامي رضا اباد,0506353070,0,0,0,0,4,0506
پاسگاه انتظامي خسرو اباد,0506353071,0,0,0,0,4,0506
پاسگاه نيروي انتظامي خان ليلي,0506353077,0,0,0,0,4,0506
پاسگاه مرزي سومار,0506353108,0,0,0,0,4,0506
کارخانه شن وماسه بوستان راه,0506353109,0,0,0,0,4,0506
پاسگاه ژاله پناه,0506353111,0,0,0,0,4,0506
پاسگاه تپه شيرو,0506353112,0,0,0,0,4,0506
پاسگاه چم نفت,0506353113,0,0,0,0,4,0506
برج احمدي,0506052854,0,0,0,0,4,0506
تپه سفيد بيگ خور,0506052856,0,0,0,0,4,0506
فتح اله اباد,0506052858,0,0,0,0,4,0506
خراطها,0506052859,0,0,0,0,4,0506
خسروي,0506052860,11,52,8,44,4,0506
خيل ناصرخان,0506052861,0,0,0,0,4,0506
سيدداود,0506052864,4,9,2,7,4,0506
قلعه سبزي سفلي,0506052866,0,0,0,0,4,0506
تازه اباد,0506052867,0,0,0,0,4,0506
قلعه شاه ملوک,0506052868,0,0,0,0,4,0506
گرصدف عزيزبيگ,0506052870,0,0,0,0,4,0506
ولدکشته,0506052871,0,0,0,0,4,0506
تپه سفيديکيشان,0506351952,0,0,0,0,4,0506
انجيرک,0506351953,0,0,0,0,4,0506
تنکاب نو,0506351954,0,0,0,0,4,0506
دربندجوق,0506353072,0,0,0,0,4,0506
تازه ابادسفلي,0506353073,0,0,0,0,4,0506
کريم اباد,0506353074,0,0,0,0,4,0506
بيمارستان,0506353119,0,0,0,0,4,0506
اران,0507208507,189,635,302,333,4,0507
سراب دهلر,0507208547,54,171,80,91,4,0507
پاقلعه,0507208514,0,0,0,0,4,0507
مزرعه چشمه کبود,0507208520,0,0,0,0,4,0507
چفته دره,0507208522,0,0,0,0,4,0507
خالنجه,0507208528,23,78,37,41,4,0507
مزرعه خوشکابخوره,0507208532,0,0,0,0,4,0507
دواب,0507208537,73,229,111,118,4,0507
دهلر ده کهنه,0507208541,33,80,42,38,4,0507
قره بناس,0507208556,65,217,101,116,4,0507
قلاته,0507208559,0,0,0,0,4,0507
کلکاه دره,0507208561,0,0,0,0,4,0507
کهريزبيدسرخ,0507208565,4,20,2,18,4,0507
گندابه,0507208570,0,0,0,0,4,0507
خوشک آبخوره,0507351396,0,0,0,0,4,0507
بيدخله,0507208513,0,0,0,0,4,0507
چشمه درازه,0507208518,18,61,30,31,4,0507
چناران,0507208525,7,23,8,15,4,0507
خلج رود,0507208530,69,236,115,121,4,0507
خيرومندان,0507208533,39,124,52,72,4,0507
داربيد,0507208534,12,38,18,20,4,0507
سراب باباعلي,0507208546,12,58,26,32,4,0507
سرخلج,0507208548,83,296,140,156,4,0507
کلان,0507208562,0,0,0,0,4,0507
کهريزکلان,0507208566,7,20,10,10,4,0507
گل زرده,0507208569,7,23,12,11,4,0507
ميرزااباد,0507208575,86,268,117,151,4,0507
وناکوه,0507208576,16,57,26,31,4,0507
هفت خاني,0507208577,4,14,6,8,4,0507
مزرعه آهنگران,0507351395,0,0,0,0,4,0507
بان ميدان عبداله,0508053167,14,47,28,19,4,0508
پادگان شهيدثابت خواه,0508053168,0,0,0,0,4,0508
کاسه گران,0508053192,60,190,96,94,4,0508
چشمه مورينه,0508053491,51,164,88,76,4,0508
طايفه همت حسن پور,0508053501,0,0,0,0,4,0508
سنگ کرموشيرزادي,0508351750,78,291,145,146,4,0508
مزرعه ميرزا اباد,0508351751,0,0,0,0,4,0508
طايفه شيرزادي,0508352049,72,235,122,113,4,0508
سد مخزني گيلانغرب,0508353165,0,0,0,0,4,0508
کشتارگاه شهرداري,0508805013,0,0,0,0,4,0508
بان ميدان دار توت,0508805014,0,0,0,0,4,0508
کلاه درازسفلي,0508053193,175,513,236,277,4,0508
کلاه درازعليا,0508053194,107,308,161,147,4,0508
کلاه درازوسطي,0508351547,46,143,69,74,4,0508
زاغه علي کرم,0508053182,21,60,33,27,4,0508
هوشيارچله,0508053197,123,395,211,184,4,0508
چشمه پهن رشيد,0508053175,50,170,81,89,4,0508
چشمه پهن فريدون,0508053190,45,153,70,83,4,0508
قمر علي,0508053191,178,538,268,270,4,0508
چشمه پهن عليشاه,0508353187,44,134,62,72,4,0508
تازه ابادبطي,0508053170,76,269,132,137,4,0508
تازه ابادحيدربيگي,0508053171,34,92,50,42,4,0508
تازه ابادصيدعلي,0508053172,71,186,90,96,4,0508
بشيرابادبطي,0508053186,13,49,25,24,4,0508
طايفه حضرتسليمان,0508351545,28,103,48,55,4,0508
پشته سماوات,0508053169,24,73,40,33,4,0508
زينل خان,0508053184,36,130,60,70,4,0508
طايفه شاعران,0508053188,37,138,74,64,4,0508
ايل شيرزادي,0508053189,128,487,240,247,4,0508
کولسون,0508053195,36,136,68,68,4,0508
عبدالعزيز,0508053201,57,190,97,93,4,0508
چالاب وارگه سفلي,0508053173,78,255,136,119,4,0508
چالاب وارگه عليا,0508053174,39,132,65,67,4,0508
چشمه سنگي روتوند,0508053176,22,67,33,34,4,0508
چشمه کبود,0508053177,24,91,42,49,4,0508
چشمه گلينه,0508053178,9,33,17,16,4,0508
چشمه نظامي,0508053179,32,140,65,75,4,0508
خيرويس,0508053180,5,21,11,10,4,0508
دربندخيزان,0508053181,14,56,26,30,4,0508
سنگچين صالح,0508053185,54,181,97,84,4,0508
اکبرجعفر,0508351736,15,43,19,24,4,0508
زيچ صالح,0508805015,0,0,0,0,4,0508
سوخور رشيد,0508053246,33,143,69,74,4,0508
سوخورمروتي,0508053247,96,319,145,174,4,0508
سوخور کرمي,0508353166,29,112,61,51,4,0508
سوخور رشيد سفلي,0508805001,46,173,85,88,4,0508
سوخورخوش اقبال,0508053239,18,79,37,42,4,0508
سوخورشهبازشيري,0508053240,82,340,167,173,4,0508
سوخورشهبازنجفي,0508053241,23,91,54,37,4,0508
سوخور علي محمد,0508053242,59,239,127,112,4,0508
سوخورکهزاد,0508053243,89,312,152,160,4,0508
سوخورنامدارميرزاپور,0508053245,49,184,93,91,4,0508
سوخورحاجي مراد,0508352050,27,95,46,49,4,0508
بهرام وند,0508053234,68,248,126,122,4,0508
قيطول,0508053250,152,469,234,235,4,0508
سوخور نامدار الهي,0508053259,39,150,75,75,4,0508
سوخورنامدارعبدي,0508351575,80,265,133,132,4,0508
بابارستم,0508053232,35,115,59,56,4,0508
کاظم خاني سفلي,0508053251,54,205,101,104,4,0508
کاظم خاني عليا,0508053252,78,284,143,141,4,0508
محمدي سفلي,0508053255,102,320,167,153,4,0508
محمدي عليا,0508053256,46,168,90,78,4,0508
گرانمير,0508805012,28,108,57,51,4,0508
قلي قلي,0508053249,174,578,289,289,4,0508
بادکان,0509051417,12,33,24,9,4,0509
عزيزاباد,0509051461,27,92,47,45,4,0509
علي يعقوب,0509051464,6,23,13,10,4,0509
کاني ساتيار,0509051471,15,59,34,25,4,0509
کاني گوهر,0509051474,26,95,46,49,4,0509
کوري,0509051479,68,243,123,120,4,0509
کولسه,0509051480,73,256,126,130,4,0509
ماسندر,0509051485,6,13,7,6,4,0509
مزرعه بوليني,0509051490,0,0,0,0,4,0509
مزرعه دريدول,0509051494,0,0,0,0,4,0509
ياري,0509051509,104,395,195,200,4,0509
يوسف خاني سفلي,0509051510,0,0,0,0,4,0509
يوسف خاني عليا,0509051511,0,0,0,0,4,0509
شيخ الکرم,0509051457,8,28,14,14,4,0509
قليجان,0509051467,0,0,0,0,4,0509
مزرعه قادراباد,0509051499,0,0,0,0,4,0509
مزرعه کچل اباد,0509051501,73,261,121,140,4,0509
مزرعه بيله اي,0509051420,33,106,52,54,4,0509
چشمه ميران,0509051435,83,305,140,165,4,0509
خوري اباد,0509051440,40,122,56,66,4,0509
عايشه دول,0509051460,15,53,27,26,4,0509
مزرعه باني ملاعلي,0509051489,0,0,0,0,4,0509
ترکه پان,0509051428,33,132,59,73,4,0509
سررودسفلي,0509051453,64,234,110,124,4,0509
کلي,0509051475,40,142,70,72,4,0509
مزرعه باني توان بزرگ,0509051487,0,0,0,0,4,0509
مزرعه باني توان کوچک,0509051488,0,0,0,0,4,0509
مزرعه شيربدر,0509051498,0,0,0,0,4,0509
بياشوش,0509051419,247,916,438,478,4,0509
سررودعليا,0509051454,80,313,145,168,4,0509
صفي اباد,0509051459,677,2402,1127,1275,4,0509
تپه بور,0509051427,5,23,10,13,4,0509
ترکه سفلي,0509051430,15,57,28,29,4,0509
ترکه عليا,0509051431,13,47,20,27,4,0509
چشمه سفيد,0509051434,18,68,26,42,4,0509
خانم اباد,0509051439,61,240,112,128,4,0509
خوش مکان سفلي,0509051441,0,0,0,0,4,0509
خوش مکان عليا,0509051442,4,17,7,10,4,0509
کاني گل سفلي,0509051472,41,169,78,91,4,0509
ترکه تازه اباد,0509051513,0,0,0,0,4,0509
حوض خله,0509051437,22,79,37,42,4,0509
ساروخان,0509051450,35,135,67,68,4,0509
علي ابادکهنه,0509051463,67,255,115,140,4,0509
کاني گل عليا,0509051473,41,168,75,93,4,0509
مزرعه بنيه,0509051491,0,0,0,0,4,0509
مزرعه تاريکه,0509051512,0,0,0,0,4,0509
بيوندعليا,0509051423,37,157,85,72,4,0509
پوينه,0509051425,0,0,0,0,4,0509
زيران,0509051449,141,535,257,278,4,0509
هانولان,0509051507,21,84,43,41,4,0509
هشت پشتوله,0509051508,0,0,0,0,4,0509
بيوندسفلي,0509051422,133,489,245,244,4,0509
سرخ بان سفلي,0509051451,59,235,111,124,4,0509
سفيدبرگ,0509051455,117,446,218,228,4,0509
بيوله,0509051421,97,370,182,188,4,0509
چاقوکل,0509051433,0,0,0,0,4,0509
حوض سيدمراد,0509051438,29,96,49,47,4,0509
سرخ بان عليا,0509051452,13,46,16,30,4,0509
شروينه,0509051458,172,599,286,313,4,0509
مزرعه بالاخاني,0509051486,0,0,0,0,4,0509
مزرعه حوض علي,0509051493,0,0,0,0,4,0509
مزرعه رشک ابي,0509051495,0,0,0,0,4,0509
مزرعه قلاچنان,0509051500,0,0,0,0,4,0509
مزرعه لااش,0509051502,0,0,0,0,4,0509
ده سرخ,0509051444,28,107,62,45,4,0509
ده توت سفلي,0509051447,80,300,134,166,4,0509
دهتوت عليا,0509051448,0,0,0,0,4,0509
علي ابادساسل,0509051462,74,259,132,127,4,0509
گنداب وسطي,0509051478,69,272,137,135,4,0509
گردک,0509051481,15,57,28,29,4,0509
گل باغي,0509051482,29,121,62,59,4,0509
گلي,0509051483,7,29,16,13,4,0509
مزرعه ساسل,0509051496,0,0,0,0,4,0509
نويل,0509051506,4,16,4,12,4,0509
پشت کلان,0510048706,29,96,41,55,4,0510
سربرزه,0510048748,35,118,62,56,4,0510
سرتخت,0510048749,135,434,223,211,4,0510
سنگ سفيد,0510048755,73,231,113,118,4,0510
سياه دره,0510048759,25,71,34,37,4,0510
کوره,0510048789,18,60,32,28,4,0510
مله بيد,0510048806,29,87,42,45,4,0510
اشرف اباد,0510048693,6,15,7,8,4,0510
بلشت,0510048700,69,222,109,113,4,0510
پويان,0510048708,31,97,53,44,4,0510
حرين,0510048724,49,124,62,62,4,0510
سادول,0510048742,33,94,49,45,4,0510
شاهپوراباد,0510048760,92,275,139,136,4,0510
قلعه سبزي,0510048768,0,0,0,0,4,0510
قزل دره,0510048774,12,37,15,22,4,0510
مزرعه کاني کبود,0510048780,0,0,0,0,4,0510
کلکان افتابرو,0510048784,24,69,34,35,4,0510
کلکان نسار,0510048785,20,63,34,29,4,0510
مزرعه گزنه تر,0510350866,0,0,0,0,4,0510
امام زاده شاه محمد,0510351772,0,0,0,0,4,0510
چوبينه,0510048197,74,221,100,121,4,0510
دره خليل,0510048203,62,153,74,79,4,0510
سلطان اباد,0510048211,12,27,16,11,4,0510
قره قاج,0510048224,75,223,115,108,4,0510
کيجي دره,0510048240,7,15,7,8,4,0510
مويينه,0510048247,95,324,160,164,4,0510
عبدل محمد,0510350871,41,121,63,58,4,0510
جاميشان سفلي,0510048188,44,119,56,63,4,0510
جاميشان عليا,0510048189,26,84,43,41,4,0510
مزرعه چالاب,0510048190,0,0,0,0,4,0510
مزرعه چشمه نظر,0510048196,0,0,0,0,4,0510
زحماني,0510048207,48,183,89,94,4,0510
شاه ويس اباد,0510048214,42,127,60,67,4,0510
شوربلاغ,0510048217,22,76,36,40,4,0510
قنداب سفلي,0510048238,20,58,27,31,4,0510
قنداب عليا,0510048239,38,131,67,64,4,0510
محمداباد,0510048242,13,43,21,22,4,0510
مزرعه فتح اله بيگي,0510350870,0,0,0,0,4,0510
برناج,0511047886,213,725,350,375,4,0511
جليلوند,0511047900,13,49,20,29,4,0511
سراب برناج,0511047921,13,51,23,28,4,0511
قشلاق درياچه,0511047955,20,71,36,35,4,0511
تلخاب,0511048950,0,0,0,0,4,0511
داروند,0511048953,16,84,40,44,4,0511
زالواب,0511048955,6,23,12,11,4,0511
قلعه علي,0511048959,0,0,0,0,4,0511
قلعه گاه,0511048960,0,0,0,0,4,0511
ازان وازان,0511047877,63,213,100,113,4,0511
برافتاب,0511047885,39,120,55,65,4,0511
چشمه سهراب,0511047906,60,196,84,112,4,0511
چشمه کبود,0511047908,6,23,13,10,4,0511
چشمه کره,0511047909,0,0,0,0,4,0511
حسين اباددرتنگ,0511047914,8,24,11,13,4,0511
قشلاق عليا,0511047959,17,64,33,31,4,0511
کمپراهداري,0511047968,0,0,0,0,4,0511
کميجه,0511047969,35,145,70,75,4,0511
نازليان,0511047992,79,293,130,163,4,0511
پادگان کربلا,0511351786,0,0,0,0,4,0511
باقراباد,0511047883,14,42,19,23,4,0511
ظلم ابادسفلي,0511047940,45,170,89,81,4,0511
ظلم ابادعليا,0511047941,47,170,83,87,4,0511
علي اباد,0511047944,21,65,34,31,4,0511
قشلاق سفلي,0511047957,0,0,0,0,4,0511
کاشانتو,0511047965,115,391,190,201,4,0511
مارانتو,0511047979,0,0,0,0,4,0511
مال اميري حاج سعادت کرم,0511047982,26,101,45,56,4,0511
محمداباد,0511047983,27,83,43,40,4,0511
مزرعه فيروزان,0511352179,0,0,0,0,4,0511
پاتپه,0511047893,110,388,178,210,4,0511
علي ابادکاشانتو,0511047945,21,86,39,47,4,0511
محمودابادکاشانتو,0511047985,58,232,108,124,4,0511
نجوبران,0511047993,125,464,212,252,4,0511
حيدراباد,0511047915,63,203,104,99,4,0511
زرداب محب,0511047918,60,244,124,120,4,0511
گرگوند,0511047974,56,191,104,87,4,0511
هريل اباد,0511047996,90,290,142,148,4,0511
مبارک آباد,0511047926,114,410,201,209,4,0511
قوزيوند,0511047960,91,310,147,163,4,0511
نادراباد,0511047991,93,364,172,192,4,0511
بلوردي قديم,0511047890,6,19,7,12,4,0511
چم بطان سفلي,0511047891,106,369,183,186,4,0511
فراش,0511047951,134,474,226,248,4,0511
قره ولي,0511047952,47,139,74,65,4,0511
مجتمع پتروشيمي کرمانشاه,0511353158,0,0,0,0,4,0511
بزن ابادسفلي,0511047887,42,134,69,65,4,0511
بزن ابادعليا,0511047888,23,89,40,49,4,0511
جهانشاه اباد,0511047901,0,0,0,0,4,0511
چم بطان عليا,0511047902,116,408,204,204,4,0511
قشلاق بزن اباد,0511047954,13,43,18,25,4,0511
قيطول,0511047961,43,150,71,79,4,0511
گوهره,0511047977,60,235,102,133,4,0511
اسحق وندسفلي,0511050330,15,66,28,38,4,0511
اسحق وندعليا,0511050331,50,210,92,118,4,0511
سرخه ده,0511050369,47,183,86,97,4,0511
حجت اباد,0511350917,5,21,12,9,4,0511
باباعلي,0511050336,40,144,69,75,4,0511
باقله,0511050338,14,54,26,28,4,0511
چم حيدر,0511050349,9,48,26,22,4,0511
چم کبود,0511050351,15,60,28,32,4,0511
چمن اسماعيل,0511050357,23,80,37,43,4,0511
ده نو,0511050364,27,103,50,53,4,0511
کرفله,0511050387,17,74,43,31,4,0511
ميدان,0511050409,48,184,83,101,4,0511
پاسار,0511350918,130,455,238,217,4,0511
باغ زينب,0511050337,32,120,64,56,4,0511
بالندرسفلي,0511050339,25,85,39,46,4,0511
برافتاب,0511050340,0,0,0,0,4,0511
جلوگيرنگه,0511050347,0,0,0,0,4,0511
جوجار,0511050348,0,0,0,0,4,0511
چم شاهي,0511050350,9,38,20,18,4,0511
چنار,0511050358,8,35,18,17,4,0511
دوراباد,0511050363,20,74,41,33,4,0511
سراسياب,0511050367,6,16,7,9,4,0511
سرخه وند,0511050370,26,98,47,51,4,0511
کله هو,0511050391,37,138,62,76,4,0511
گرمابه,0511050393,0,0,0,0,4,0511
گره بان,0511050395,41,101,42,59,4,0511
گنجوان,0511050396,39,146,61,85,4,0511
ميرمنگه,0511050410,16,65,33,32,4,0511
پشت گله سفلي,0511221768,0,0,0,0,4,0511
پشت گله عليا,0511221769,0,0,0,0,4,0511
پشت گله وسطي,0511221770,0,0,0,0,4,0511
چله خاني,0511221802,0,0,0,0,4,0511
بالندرعليا,0511350919,0,0,0,0,4,0511
قوطي دره بالا,0511221870,11,39,15,24,4,0511
قوطي دره پايين,0511221871,0,0,0,0,4,0511
کماسي سفلي,0511221879,16,72,38,34,4,0511
کماسي عليا,0511221880,0,0,0,0,4,0511
کماسي وسطي,0511221881,24,87,46,41,4,0511
مزرعه هوله قوچالي,0512050847,0,0,0,0,4,0512
ظلم سور,0512050903,24,74,35,39,4,0512
کيسله,0512050934,35,111,55,56,4,0512
واني سر,0512050976,42,134,69,65,4,0512
تله توت,0512352101,4,21,10,11,4,0512
باني هو,0512050797,10,37,19,18,4,0512
تيره عالي,0512050822,79,308,161,147,4,0512
جاسوسکه,0512050823,7,28,13,15,4,0512
حرميان سفلي,0512050839,6,32,16,16,4,0512
حرميان عليا,0512050840,28,91,43,48,4,0512
خدامروت,0512050849,8,42,25,17,4,0512
خسروباشه,0512050850,9,39,21,18,4,0512
ده شيخ,0512050873,0,0,0,0,4,0512
ده هوله سفلي,0512050874,19,73,36,37,4,0512
ده هوله عليا,0512050875,42,145,75,70,4,0512
رويله,0512050876,0,0,0,0,4,0512
سرخه ده,0512050885,23,80,45,35,4,0512
کلاه سياه,0512050929,28,106,58,48,4,0512
مجتمع ميدان نمک,0512352100,64,265,140,125,4,0512
آب سرخ,0512050786,5,24,17,7,4,0512
اشکي,0512050789,6,27,17,10,4,0512
تاکانه,0512050815,7,24,14,10,4,0512
جيور,0512050827,5,21,12,9,4,0512
دستگردي,0512050860,0,0,0,0,4,0512
سرگوراز,0512050887,0,0,0,0,4,0512
کتکه,0512050922,23,63,34,29,4,0512
کولي هور,0512050933,4,14,9,5,4,0512
مارگير,0512050943,0,0,0,0,4,0512
نهنگ,0512050971,50,189,90,99,4,0512
بخش نوخاص,0512051269,30,128,68,60,4,0512
سياناب پرآب,0512051292,46,190,95,95,4,0512
علي خاني,0512051295,25,109,56,53,4,0512
هماجگه,0512051332,64,252,122,130,4,0512
خازنک,0512805004,134,459,247,212,4,0512
باني نار,0512050796,50,210,97,113,4,0512
درمي سفلي,0512050857,0,0,0,0,4,0512
شيخ سله,0512050902,393,1425,685,740,4,0512
گزنه,0512050940,25,123,59,64,4,0512
درمي عليا,0512805005,0,0,0,0,4,0512
باني پارياب,0512050793,27,102,49,53,4,0512
پشتگور چقاماران,0512050807,56,201,108,93,4,0512
چقاماران برگور,0512050835,12,49,26,23,4,0512
چوپانکاره,0512050836,0,0,0,0,4,0512
سرطاويره,0512050886,0,0,0,0,4,0512
سه تپان,0512050893,5,22,11,11,4,0512
قاليچه,0512050912,109,478,230,248,4,0512
کاني خنجر,0512050919,41,152,74,78,4,0512
کزه اي ملاسبحان,0512050927,0,0,0,0,4,0512
ميدان نمک سفلي,0512050966,0,0,0,0,4,0512
ميدان نمک عليا,0512050967,0,0,0,0,4,0512
نگه,0512050970,0,0,0,0,4,0512
گردي قاسم خاني (نيمه کاره),0512050974,94,341,159,182,4,0512
هفت کاني,0512050979,4,18,7,11,4,0512
کاني رش,0512050982,61,237,116,121,4,0512
سردسير فرامرز,0512353182,18,86,47,39,4,0512
قره ژاله مهرعلي,0512351991,0,0,0,0,4,0512
بان اخ ويس امام حسن,0512351992,0,0,0,0,4,0512
داره لار علي جان,0512351993,7,26,12,14,4,0512
غازان دول عبداله,0512351999,0,0,0,0,4,0512
داره لارعبدالکريم,0512352002,0,0,0,0,4,0512
غازان دول عليمراد,0512352003,0,0,0,0,4,0512
ژالان شاهگل فرهاد,0512352005,21,93,41,52,4,0512
پشت پله ژاله امين,0512352006,0,0,0,0,4,0512
تپه کبود حسن,0512352010,16,59,30,29,4,0512
تپه کبودسفلي عبدلمحمد,0512352011,14,54,27,27,4,0512
عبدلان ميرکي,0512352012,23,100,44,56,4,0512
نقده عليا,0512352013,0,0,0,0,4,0512
پشت تنگ گاري,0512352014,19,92,45,47,4,0512
کلاوه ميرکي,0512352015,0,0,0,0,4,0512
سيوانه علياامين,0512352016,0,0,0,0,4,0512
سيوانه سه تيان,0512352017,0,0,0,0,4,0512
سيوانه دارچک,0512352018,7,27,12,15,4,0512
علي اقايي بالايي باني چنور,0512352019,0,0,0,0,4,0512
کاني دزانه حاجي حسين,0512352020,5,21,7,14,4,0512
کاک ميرکي,0512352021,4,17,10,7,4,0512
تق تق علي آقايي,0512352022,0,0,0,0,4,0512
داري زنگنه سفلي,0512352023,21,69,39,30,4,0512
دره ژاله سفلي,0512352026,63,196,100,96,4,0512
دره ژاله عليا,0512352027,0,0,0,0,4,0512
داري زنگنه شيخ حسن,0512352028,0,0,0,0,4,0512
قلانيه عليا,0512352029,0,0,0,0,4,0512
قلانيه سفلي,0512352030,0,0,0,0,4,0512
زلاني,0512352032,0,0,0,0,4,0512
اسپر مصطفي خان (بر اسپر),0512352033,11,34,19,15,4,0512
اسپرباراني,0512352034,0,0,0,0,4,0512
ژاله کوسه,0512352035,16,61,31,30,4,0512
نقده سفلي,0512352036,4,15,6,9,4,0512
مزرعه کاني کريم يار ولي,0512352102,10,44,19,25,4,0512
ژالان تپه کاکه عزيز,0512352104,23,100,49,51,4,0512
سورمر,0512353082,0,0,0,0,4,0512
بان آخ ويس براخاص,0512353143,4,17,8,9,4,0512
خور نوکيان,0512353179,4,15,7,8,4,0512
قيطول,0512353181,0,0,0,0,4,0512
دربنددهل,0512353183,18,66,30,36,4,0512
دوله خشک عزيز,0512353184,8,34,21,13,4,0512
بانگار عليا,0512353188,25,92,52,40,4,0512
بانگار سفلي,0512353189,14,53,26,27,4,0512
بارنگارعزيز,0512353190,0,0,0,0,4,0512
کوري,0512353191,0,0,0,0,4,0512
گردل گاري علي اقا,0512351994,11,40,19,21,4,0512
تازه ابادگردل گاري,0512351995,0,0,0,0,4,0512
دارنيله عزيز,0512351997,0,0,0,0,4,0512
دره اسياب رشيد,0512351998,5,34,15,19,4,0512
مله کرمينه شاهمراد,0512352000,9,38,21,17,4,0512
کلاوه گاري,0512352001,5,33,17,16,4,0512
دارنيله اسکندر,0512352004,0,0,0,0,4,0512
تازه ابادگاري خان محمد,0512352008,0,0,0,0,4,0512
پوکه عباس,0512352009,0,0,0,0,4,0512
پلک مله کرمينه,0512352103,0,0,0,0,4,0512
هوش گوه سيد محمد ورضا علي,0512352105,9,42,19,23,4,0512
مجتمع امام علي,0512805010,26,95,49,46,4,0512
ديوگه بي بيان,0513046669,44,200,92,108,4,0513
چالاب قتکه بارس,0513046675,5,14,6,8,4,0513
دشت مورت سفلي,0513046683,29,131,62,69,4,0513
دشت مورت عليا,0513046684,12,51,27,24,4,0513
دوشميان,0513046686,144,578,271,307,4,0513
زاغه دشت مورت,0513046689,18,67,33,34,4,0513
شويل صادق خان,0513046691,30,120,62,58,4,0513
عبدالکريم بارس,0513046692,0,0,0,0,4,0513
گزن,0513046696,15,58,28,30,4,0513
کارخانه ايل رستم,0513046663,163,633,308,325,4,0513
قلعه زنجيرسفلي,0513046693,5,29,18,11,4,0513
قلعه زنجيرعليا,0513046694,98,412,213,199,4,0513
گردکان کوره شهباز,0513046695,77,331,162,169,4,0513
بروندسفلي,0513046667,60,220,106,114,4,0513
بروندعليا,0513046668,19,70,29,41,4,0513
بيامه سفلي,0513046670,107,359,186,173,4,0513
بيامه عليا,0513046671,44,144,76,68,4,0513
بريشاه خوبيار,0513046672,68,243,118,125,4,0513
بي نهرعليا,0513046832,59,198,96,102,4,0513
باني بيد,0513046666,58,211,105,106,4,0513
ميرهوارياري,0513046699,0,0,0,0,4,0513
بان سولاب شيرمحمد,0513046815,18,46,19,27,4,0513
بان شيروان تفنگچي,0513046818,10,36,20,16,4,0513
بان سولاب ناوخاص,0513046824,4,9,5,4,4,0513
بيرقوند,0513046827,105,380,193,187,4,0513
تازه اباد شاهگدار,0513046835,0,0,0,0,4,0513
تازه آباد شايگان,0513046836,0,0,0,0,4,0513
کامران مولايي,0513046837,8,27,13,14,4,0513
درمران سفلي,0513046864,37,148,76,72,4,0513
درمران عليا,0513046865,13,50,22,28,4,0513
کامران بيگ رضا,0513046891,52,169,96,73,4,0513
کامران رحمان,0513046892,21,76,43,33,4,0513
خيل سبزه,0513046680,0,0,0,0,4,0513
خيل موالي نجف,0513046681,18,80,30,50,4,0513
دنگه خدايار,0513046685,9,42,20,22,4,0513
بان سولاب کلب علي,0513046816,33,100,48,52,4,0513
بان سولاب حاتم,0513046817,40,136,67,69,4,0513
بريشاه بيگ مراد,0513046825,18,58,30,28,4,0513
بيله هوسفلي,0513046828,11,42,24,18,4,0513
بيله هوعليا,0513046829,16,52,30,22,4,0513
بي نهرسفلي,0513046831,30,97,44,53,4,0513
زاوله سفلي,0513046870,35,125,77,48,4,0513
زاوله عليا,0513046871,44,159,79,80,4,0513
دومي زر,0513046888,13,47,25,22,4,0513
داره رش محمدسلطان,0513351686,51,219,106,113,4,0513
بان ياران تيمور,0513046821,25,78,39,39,4,0513
بان ياران ميرزاحسين,0513046823,14,36,21,15,4,0513
دره نيجه,0513046866,8,41,22,19,4,0513
درويت,0513046867,67,235,112,123,4,0513
علي باراني,0513046887,55,214,115,99,4,0513
گورگاورز,0513046909,40,145,73,72,4,0513
مزرعه تمبر,0513046912,0,0,0,0,4,0513
مزرعه کوهالي,0513046914,0,0,0,0,4,0513
مله يعقوب,0513046918,12,33,17,16,4,0513
امامزاده داود,0513046589,0,0,0,0,4,0513
امامزاده بابايادگار,0513046592,0,0,0,0,4,0513
زرده,0513046597,318,1087,544,543,4,0513
سيدمحمد,0513046598,47,178,80,98,4,0513
داراب,0513046594,196,764,392,372,4,0513
قلقله,0513046601,48,172,87,85,4,0513
کوشکري,0513046602,165,626,315,311,4,0513
ياران,0513046603,45,179,93,86,4,0513
ژالگه حسين,0513046588,57,203,99,104,4,0513
دره لرز ريجاب,0513046596,0,0,0,0,4,0513
ده ليلي,0514051446,89,344,164,180,4,0514
شبان کاره,0514051456,111,375,198,177,4,0514
بنچله,0514051625,164,568,277,291,4,0514
بزگوره,0514051418,49,161,83,78,4,0514
قوري قلعه,0514051468,254,891,451,440,4,0514
لورابي,0514051484,0,0,0,0,4,0514
مزرعه هدگه,0514051503,0,0,0,0,4,0514
نوخان,0514051505,4,13,6,7,4,0514
بانشله,0514051619,0,0,0,0,4,0514
بدراباد,0514051620,106,338,165,173,4,0514
بناوچ,0514051624,24,103,48,55,4,0514
خانم اباد,0514051635,26,88,44,44,4,0514
زيرجوبي,0514051646,39,135,57,78,4,0514
صادق اباد,0514051653,42,143,68,75,4,0514
علي اباد,0514051654,21,64,31,33,4,0514
مزرعه کاني چرمو,0514051659,0,0,0,0,4,0514
کاني خضران,0514051660,25,102,43,59,4,0514
مراداباد,0514051675,64,225,102,123,4,0514
مزرعه بروداره,0514051678,0,0,0,0,4,0514
باباعزيز,0514051617,52,178,85,93,4,0514
برهان الدين,0514051621,63,193,91,102,4,0514
دکل مخابراتي,0514051640,0,0,0,0,4,0514
سلکان,0514051650,30,95,47,48,4,0514
قلانجه,0514051657,129,427,219,208,4,0514
کاني کبود,0514051661,16,62,28,34,4,0514
کاني کچکينه,0514051662,7,23,11,12,4,0514
مزرعه ده صفک,0514051685,0,0,0,0,4,0514
مسکين ابادسفلي,0514051691,0,0,0,0,4,0514
مسکين ابادعليا,0514051692,27,89,42,47,4,0514
دکل مخابرات,0514352931,0,0,0,0,4,0514
شهرک کارگاه هاي صنعتي,0514805017,0,0,0,0,4,0514
بله زين سفلي,0514051622,8,30,18,12,4,0514
بله زين عليا,0514051623,0,0,0,0,4,0514
ده باوگه,0514051643,20,79,37,42,4,0514
سردم,0514051649,88,341,158,183,4,0514
قلاين,0514051658,44,175,78,97,4,0514
کلاوه,0514051664,31,113,55,58,4,0514
گرگيدر,0514051667,62,221,100,121,4,0514
مزرعه جابري,0514051680,0,0,0,0,4,0514
مهرگان,0514051693,42,183,84,99,4,0514
مزرعه روانسر,0514051695,0,0,0,0,4,0514
شرکت پلاستيک سازي اورامان غرب,0514353104,0,0,0,0,4,0514
خراجيان,0514051637,147,564,250,314,4,0514
مزرعه چشمه سفيد,0514051681,0,0,0,0,4,0514
چشمه کبود,0501047639,52,174,81,93,4,0501
دواردرميان عليا,0501047644,0,0,0,0,4,0501
مزرعه چشمه کبوداعظم,0501047658,0,0,0,0,4,0501
ميان چقا,0501047661,16,52,21,31,4,0501
امامزاده حسن,0501047697,0,0,0,0,4,0501
چهارمله سفلي,0501047708,39,111,60,51,4,0501
چهارمله عليا,0501047709,56,158,87,71,4,0501
روتوند,0501047712,23,84,41,43,4,0501
مزرعه پرويز,0501047727,0,0,0,0,4,0501
مزرعه سوليجه,0501047730,0,0,0,0,4,0501
مزرعه شيخي,0501047731,0,0,0,0,4,0501
مومنايي,0501047736,101,326,152,174,4,0501
کمانگير,0501224971,16,60,32,28,4,0501
مزرعه هزارچشمه,0501351760,0,0,0,0,4,0501
زعفران سفلي,0501047646,14,35,12,23,4,0501
زعفران عليا,0501047647,117,373,178,195,4,0501
قلاجي,0501047722,6,23,8,15,4,0501
بان درعليا,0501047630,61,175,86,89,4,0501
بان هزارسفلي,0501047631,0,0,0,0,4,0501
بان هزارعليا,0501047632,0,0,0,0,4,0501
داربيدمنصوري,0501047641,135,410,204,206,4,0501
دواب,0501047642,0,0,0,0,4,0501
دواردرميان سفلي,0501047643,39,102,40,62,4,0501
سرخه خاني,0501047650,27,69,33,36,4,0501
سياه پله سفلي,0501047651,6,15,10,5,4,0501
سياه پله عليا,0501047652,0,0,0,0,4,0501
شغل بهاراب,0501047653,8,27,13,14,4,0501
کلک جعفر,0501047655,8,23,8,15,4,0501
کمرسوراخ,0501047657,37,103,56,47,4,0501
ميان تنگ منصوري,0501047660,34,89,49,40,4,0501
باندرسفلي,0501351688,30,71,34,37,4,0501
خوکاب م نصوري,0501047640,0,0,0,0,4,0501
سربکوه,0501047649,15,50,22,28,4,0501
گاوراني,0501047724,162,513,244,269,4,0501
چشمه سنگي,0501350157,164,494,239,255,4,0501
بيک زاده,0501047105,56,203,110,93,4,0501
چشمه ولگه,0501047119,10,36,18,18,4,0501
کله جوب,0501047151,188,892,332,560,4,0501
منصوراباد,0501047159,72,257,128,129,4,0501
مزرعه کله چوب,0501350166,0,0,0,0,4,0501
بورک,0501047104,56,201,101,100,4,0501
تازه ابادکوکاو,0501047109,4,17,6,11,4,0501
جاف برسيمين,0501047115,15,41,13,28,4,0501
چالاب کريم,0501047116,0,0,0,0,4,0501
سياه سياه حبيب,0501047136,23,77,37,40,4,0501
سياه سياه شيخه,0501047137,52,150,80,70,4,0501
سياسياي کيخسرو,0501047138,197,656,315,341,4,0501
کوکاو,0501047153,22,67,28,39,4,0501
سياه سياه خسروي,0501350143,24,74,36,38,4,0501
موميي,0501047160,360,1211,639,572,4,0501
پيرگه برسيمين,0501047108,63,184,105,79,4,0501
موش کش,0501047164,168,544,275,269,4,0501
لر,0501047155,84,327,154,173,4,0501
پادگان الله اکبر,0501351697,86,623,142,481,4,0501
پمپ بنزين آهن جان,0501351757,0,0,0,0,4,0501
منبع اب اسلام اباد,0501352976,0,0,0,0,4,0501
معدن سنگ بدره اي,0501352978,0,0,0,0,4,0501
برف ابادسفلي,0501047101,22,82,47,35,4,0501
چقاکل,0501047124,135,455,222,233,4,0501
ونايي,0501047162,187,666,338,328,4,0501
پادگان سلمان فارسي,0501047106,24,170,45,125,4,0501
تراب,0501047110,90,325,164,161,4,0501
ترازک عبداله,0501047111,16,53,27,26,4,0501
ترازک کسان,0501047112,47,172,85,87,4,0501
جوزه انجيرک,0501047113,6,26,12,14,4,0501
چشمه خير,0501047117,0,0,0,0,4,0501
زواره کوه,0501047129,35,100,49,51,4,0501
سراب کولسه,0501047132,6,18,10,8,4,0501
سرتوميلکه غلام,0501047133,0,0,0,0,4,0501
سکوي کولسه,0501047134,7,25,12,13,4,0501
طايفه باباخان,0501047140,0,0,0,0,4,0501
ميلگه سياه سياه,0501047143,18,57,24,33,4,0501
نوشکله ترازو,0501047161,31,106,53,53,4,0501
مزرعه پيله صوفي,0501350121,8,31,13,18,4,0501
مزرعه توه خشکه,0501350123,0,0,0,0,4,0501
مزرعه طايفه علي جان,0501350132,4,12,6,6,4,0501
طايفه نامدارپرنا,0501351765,4,13,4,9,4,0501
چالاب بکر,0501053373,202,755,366,389,4,0501
سيلو,0501047139,7,28,14,14,4,0501
علي اباد,0501047144,258,898,450,448,4,0501
فيروزاباد,0501047145,43,147,76,71,4,0501
ايستگاه تحقيقات باغباني,0501350106,0,0,0,0,4,0501
پست برق,0501351770,0,0,0,0,4,0501
اميراباد,0501047097,367,1270,627,643,4,0501
دارامرودسفلي,0502049578,32,124,68,56,4,0502
دارامرودعليا,0502049579,31,118,60,58,4,0502
سرپوزل,0502049593,17,65,35,30,4,0502
سرونوسفلي,0502049597,190,694,325,369,4,0502
کهريزسفلي,0502049620,32,124,67,57,4,0502
اسداباد,0502049549,5,12,8,4,4,0502
چشمه سفيد,0502049563,12,47,23,24,4,0502
چله سفلي,0502049566,0,0,0,0,4,0502
چله عليا,0502049567,50,174,81,93,4,0502
حسن آباد رويين تن,0502049571,12,35,16,19,4,0502
خرگ اب سفلي,0502049573,0,0,0,0,4,0502
خرگ اب عليا,0502049574,34,99,50,49,4,0502
خرگ اب وسطي,0502049575,0,0,0,0,4,0502
داربيد,0502049581,0,0,0,0,4,0502
سرچم,0502049595,0,0,0,0,4,0502
سياه گل,0502049599,45,197,102,95,4,0502
ظلان سفلي,0502049605,5,21,7,14,4,0502
ظلان عليا,0502049606,15,47,25,22,4,0502
علي اباد,0502049607,4,18,8,10,4,0502
کنارمرگ,0502049617,32,128,61,67,4,0502
کهريزعليا,0502049621,0,0,0,0,4,0502
گاميزج سفلي,0502049622,0,0,0,0,4,0502
گاميزج عليا,0502049623,46,176,84,92,4,0502
موسي نارنج,0502049634,22,76,43,33,4,0502
ميانه,0502049637,21,76,37,39,4,0502
نظرگاه,0502049640,0,0,0,0,4,0502
گاميزج وسطي,0502351679,0,0,0,0,4,0502
احمداباد,0502352902,7,28,12,16,4,0502
اخوندي,0502048985,17,71,40,31,4,0502
تالاندشت,0502048987,26,112,55,57,4,0502
تق تق,0502048988,10,36,20,16,4,0502
تکيه سفلي,0502048989,26,111,58,53,4,0502
توه روييله حاجي محمد,0502048990,0,0,0,0,4,0502
توه روييله عليا,0502048991,0,0,0,0,4,0502
طاويران سفلي,0502048992,28,97,51,46,4,0502
طاويران عليا,0502048993,100,372,172,200,4,0502
خليلان سفلي,0502049576,0,0,0,0,4,0502
خليلان عليا,0502049577,23,88,49,39,4,0502
دوبرجي,0502049583,16,67,38,29,4,0502
شاه بداغ,0502049601,21,87,43,44,4,0502
گزاف سفلي,0502049625,21,81,42,39,4,0502
گزاف عليا,0502049626,4,17,5,12,4,0502
مزرعه ميانه مفروضه,0502351794,0,0,0,0,4,0502
سرونوعليا,0502049598,172,582,280,302,4,0502
کاروانه عليا,0502049612,24,87,41,46,4,0502
باغ بيگلري,0502049550,13,51,27,24,4,0502
چروريش,0502049562,9,27,15,12,4,0502
ديلانچي سفلي,0502049584,30,117,58,59,4,0502
ديلانچي عليا,0502049585,16,54,23,31,4,0502
سرتپه زنگنه,0502049594,15,52,24,28,4,0502
طهنه سفلي,0502049602,44,177,92,85,4,0502
طهنه عليا,0502049603,20,78,40,38,4,0502
طهنه وسطي,0502049604,25,104,49,55,4,0502
کوره خسروي,0502049619,15,52,21,31,4,0502
نوجوب,0502049641,59,229,124,105,4,0502
طهنه نوراله,0502351071,5,18,6,12,4,0502
مزرعه سرتپه سلطانعلي,0502351793,0,0,0,0,4,0502
باغ طيغون,0502049551,86,310,158,152,4,0502
پشته ريزه سفلي,0502049554,14,55,27,28,4,0502
پشته ريزه وسطي,0502049556,16,68,34,34,4,0502
زمان اباد,0502049587,26,102,44,58,4,0502
کژک,0502049610,61,272,127,145,4,0502
کله جوب,0502049616,77,292,147,145,4,0502
مزرعه غريبه,0502351792,0,0,0,0,4,0502
باغ کرم بيگ,0502049552,56,228,107,121,4,0502
پشته ريزه عليا,0502049555,0,0,0,0,4,0502
چشمه ماکان,0502049565,22,77,39,38,4,0502
گلدره,0502049631,34,115,54,61,4,0502
گوني,0502049632,33,132,71,61,4,0502
مهدي ابادسفلي,0502049635,58,225,109,116,4,0502
مهدي ابادعليا,0502049636,29,106,47,59,4,0502
نورسفلي,0502049642,33,115,54,61,4,0502
نورعليا,0502049643,43,158,82,76,4,0502
چراغ اباد,0502049561,10,37,18,19,4,0502
داربدره,0502049580,26,90,50,40,4,0502
سراب,0502049592,144,525,264,261,4,0502
قمش,0502049609,27,113,47,66,4,0502
کره جوب,0502049615,0,0,0,0,4,0502
سامله عليا,0502049589,34,143,70,73,4,0502
سيد علي قاسمي,0502221419,14,63,28,35,4,0502
کالگه اميد علي,0502221497,25,107,49,58,4,0502
ابطاف,0502225104,29,108,53,55,4,0502
بان ريوند,0502225106,10,38,15,23,4,0502
چمنوزده,0502225121,10,40,13,27,4,0502
چنار,0502225122,7,25,11,14,4,0502
زنگي,0502225124,21,63,34,29,4,0502
کولسه,0502225134,0,0,0,0,4,0502
گدارپيرسفلي,0502225135,47,192,93,99,4,0502
گدارپيرعليا,0502225136,6,30,17,13,4,0502
گردکاندارعليا,0502225139,11,38,18,20,4,0502
ميان سراوان,0502225143,20,98,49,49,4,0502
گردکاندارسفلي,0502352175,6,12,7,5,4,0502
چم نوزده,0502451247,0,0,0,0,4,0502
ريخل,0502049586,7,25,10,15,4,0502
سامله سفلي,0502049588,53,194,93,101,4,0502
سخرسفلي,0502049590,18,59,27,32,4,0502
سخرعليا,0502049591,59,219,98,121,4,0502
فيروز اباد,0502049608,57,186,88,98,4,0502
کرگان,0502049614,21,83,39,44,4,0502
گلم کبودعليا,0502049629,5,8,5,3,4,0502
گلم کبودوسطي,0502049630,0,0,0,0,4,0502
باغ ياسم,0502225105,0,0,0,0,4,0502
چشمه پونه,0502225120,0,0,0,0,4,0502
معدن سنگ سرفيروزاباد,0502352901,0,0,0,0,4,0502
نجف اباد,0502049639,106,398,184,214,4,0502
پاسگاه ميدان تير,0502049553,0,0,0,0,4,0502
تنوره,0502049557,6,26,12,14,4,0502
جلو,0502049558,55,201,106,95,4,0502
جيرانبلاغ,0502049559,46,251,75,176,4,0502
چالاب پايين,0502049560,23,81,40,41,4,0502
چشمه کبود,0502049564,7,25,9,16,4,0502
دربندزرد,0502049582,12,41,22,19,4,0502
کوچک دانه,0502049618,0,0,0,0,4,0502
گلم کبودسفلي,0502049628,11,42,23,19,4,0502
وليخاني,0502049644,24,81,43,38,4,0502
سردار,0502351096,64,261,122,139,4,0502
سيدشکر,0502351097,19,56,29,27,4,0502
مزرعه قلعه پوق وپاق,0502351795,0,0,0,0,4,0502
معدن سنگ جلو,0502353019,0,0,0,0,4,0502
معدن سنگ دربند زرد,0502353020,0,0,0,0,4,0502
چشمه کبود,0502353186,0,0,0,0,4,0502
بانلريني,0502049747,43,163,83,80,4,0502
چقاکلب علي,0502049778,73,267,124,143,4,0502
چهارزبرسفلي,0502049782,81,271,128,143,4,0502
چهارزبرعليا,0502049783,47,153,64,89,4,0502
ميرگ,0502049894,35,125,61,64,4,0502
مزرعه گلين لعل اباد,0502353007,0,0,0,0,4,0502
پيرحياتي سفلي,0502049755,48,148,80,68,4,0502
پيرحياتي وسطي,0502049757,28,97,48,49,4,0502
چقازرد,0502049775,97,340,171,169,4,0502
چقاصفر,0502049777,45,146,74,72,4,0502
چقاگينو,0502049779,70,240,127,113,4,0502
علي ابادعليا,0502049841,10,33,17,16,4,0502
لعل ابادحسينقلي خاني,0502049870,92,330,155,175,4,0502
لعل ابادسيدجعفري,0502049871,74,238,113,125,4,0502
لعل ابادسيدصادق,0502049872,40,144,71,73,4,0502
لعل ابادکل کل دو,0502049873,25,81,36,45,4,0502
لعل ابادکل کل يک,0502049874,25,85,39,46,4,0502
ريزوند لعل اباد,0502049890,0,0,0,0,4,0502
ميمز,0502049895,47,151,70,81,4,0502
پيرحياتي عليا,0502049756,0,0,0,0,4,0502
ذالکه حاج عباسقلي,0502049805,22,73,39,34,4,0502
ذالگه حاج فرج منتظري,0502049806,15,56,23,33,4,0502
ذالکه وزيري,0502049807,22,68,37,31,4,0502
بلمانه رفيق آباد سفلي,0502049748,27,95,47,48,4,0502
بلمانه موقوفه عليا,0502049749,34,125,59,66,4,0502
چالابه سفلي,0502049765,41,136,58,78,4,0502
چالابه عليا,0502049766,48,158,78,80,4,0502
خزل,0502049789,24,73,32,41,4,0502
سامره سفلي,0502049815,28,98,49,49,4,0502
سامره عليا,0502049816,54,183,85,98,4,0502
سيد نقي رفيق آباد,0502049828,21,76,38,38,4,0502
عالي بر,0502049837,5,17,8,9,4,0502
حاجي ابادسه,0502049568,0,0,0,0,4,0502
حاجي ابادعليا,0502049569,0,0,0,0,4,0502
حاجي اباديک,0502049570,0,0,0,0,4,0502
خرخرسفلي,0502049572,18,69,36,33,4,0502
گرميان پشت راه,0502049624,7,22,8,14,4,0502
مزرعه گرميان زيرراه,0502049633,0,0,0,0,4,0502
حاجي ابادسفلي,0502049784,0,0,0,0,4,0502
رشبوگر,0502049813,43,128,60,68,4,0502
سياه کمرسفلي,0502049824,37,107,43,64,4,0502
سياه کمرشيخه,0502049825,6,16,5,11,4,0502
سياه کمرعليا,0502049826,15,51,25,26,4,0502
سياکمرعليامعروف,0502049827,7,23,9,14,4,0502
قلعه نجفعلي خان,0502049843,83,282,136,146,4,0502
قلندرلکي,0502049844,67,198,91,107,4,0502
دوکوشکان رضاخاني,0502049888,28,76,32,44,4,0502
حاجي اباد نصير السلطان,0502049785,44,126,64,62,4,0502
دوکوشکان حسينخاني,0502049798,8,21,10,11,4,0502
دولتابادسفلي,0502049799,29,87,36,51,4,0502
دولتابادعليا,0502049800,27,104,47,57,4,0502
ديزگران سفلي,0502049803,0,0,0,0,4,0502
ديزگران عليا,0502049804,0,0,0,0,4,0502
ريزه وند,0502049814,116,381,190,191,4,0502
سياه چقاي سفلي,0502049822,15,46,20,26,4,0502
سياه چقاي عليا,0502049823,6,17,11,6,4,0502
قمشه باباکرم خان,0502049845,17,73,34,39,4,0502
قيماس,0502049856,31,91,42,49,4,0502
مزرعه عبدالحميدتمري,0502049884,0,0,0,0,4,0502
پليس راه کرمانشاه اسلام اباد,0502049754,0,0,0,0,4,0502
توه لطيف,0502049761,73,252,130,122,4,0502
قمشه تپه,0502049846,91,338,166,172,4,0502
قمشه سيدامين,0502049847,6,22,13,9,4,0502
قمشه سيدقاسم,0502049848,139,494,237,257,4,0502
مجتمع قدس کميته امدادامام,0502049759,0,0,0,0,4,0502
جامه شوران,0502049762,79,235,117,118,4,0502
جامه شوران عليا,0502049763,112,322,150,172,4,0502
کليايي,0502049862,72,245,124,121,4,0502
مرکزاموزش کشاورزي,0502049882,0,0,0,0,4,0502
ايستگاه تحقيقات ماهيدشت,0502049883,0,0,0,0,4,0502
مزرعه بنيادامور جنگزدگان,0502049886,4,12,5,7,4,0502
چقابلک خواجه باشي,0502049769,56,175,84,91,4,0502
چقابلک کوچک,0502049771,17,57,27,30,4,0502
چقابلک محمدزمان,0502049772,28,102,53,49,4,0502
قمشه سيديعقوب,0502049849,112,351,176,175,4,0502
قمشه لرزنگنه,0502049850,55,197,98,99,4,0502
چاوشان,0502049767,36,121,54,67,4,0502
درگه غلامعلي,0502049791,31,95,46,49,4,0502
درگه چشمه سعيد,0502049792,13,41,17,24,4,0502
درگه خليفه قلي,0502049793,11,28,11,17,4,0502
درگه محمدعلي,0502049794,0,0,0,0,4,0502
سيمينه سفلي,0502049829,67,222,114,108,4,0502
سيمينه عليا,0502049830,75,270,132,138,4,0502
درگه حسن خان,0502049887,0,0,0,0,4,0502
درگه ملاعلي کرم,0502351839,29,94,49,45,4,0502
حاجي عزيز چشمه سفيد,0502352809,91,287,134,153,4,0502
چشمه سفيد,0502049768,300,933,448,485,4,0502
دم شمشه,0502049790,0,0,0,0,4,0502
مزرعه پشتوه,0502049885,0,0,0,0,4,0502
پست 63کيلووات شهيد اکبري,0502049900,0,0,0,0,4,0502
چشمه سفيداقابيگي,0502046852,5,16,10,6,4,0502
چشمه سفيدشاهمراد,0502046853,6,16,7,9,4,0502
دارگل سيدحسن,0502046860,13,46,20,26,4,0502
دارگل سيدسليم,0502046861,7,19,8,11,4,0502
دارگل تيمز,0502046862,25,83,40,43,4,0502
رشيدعلي,0502046868,30,100,55,45,4,0502
شيرزاداباد,0502046880,9,30,12,18,4,0502
صوفي وند,0502046882,22,64,30,34,4,0502
علي ابادگل بانو,0502046886,11,36,19,17,4,0502
مزرعه سيدفريدون,0502046913,0,0,0,0,4,0502
ميرکه قلعه قاضي,0502046919,34,98,54,44,4,0502
بازياني,0502047239,18,58,34,24,4,0502
چشمه سياه,0502047258,19,55,34,21,4,0502
دارخوراقارضا,0502047277,26,86,40,46,4,0502
گلالي,0502047339,37,110,52,58,4,0502
ميلکه بوچان,0502047361,17,54,34,20,4,0502
ميلکه شيرخان,0502047362,12,38,18,20,4,0502
هفت اشيان,0502047373,36,113,59,54,4,0502
چشمه سفيدصفر,0502351696,0,0,0,0,4,0502
اميراباد,0502047235,10,52,30,22,4,0502
بيدگل,0502047243,31,110,52,58,4,0502
تازه ابادبيدگلي,0502047248,6,19,9,10,4,0502
تازه ابادمريواني,0502047250,4,16,7,9,4,0502
زندهر,0502047292,22,77,39,38,4,0502
مريواني بيد گل,0502047345,26,100,57,43,4,0502
مزرعه بيدگل سفلي,0502047347,0,0,0,0,4,0502
مزرعه جمشيداباد,0502047349,0,0,0,0,4,0502
ميلکه باقر,0502047360,8,26,12,14,4,0502
تازه ابادخسرو,0502047375,0,0,0,0,4,0502
زامله,0502048740,74,298,157,141,4,0502
ساز,0502048743,47,192,100,92,4,0502
سراب شاه حسين,0502048747,34,130,59,71,4,0502
سرزامله,0502048751,8,30,14,16,4,0502
کاليان سفلي,0502048776,33,101,48,53,4,0502
کاليان عليا,0502048777,58,205,109,96,4,0502
کاليان وسطي,0502048778,93,353,184,169,4,0502
وزمله,0502048812,22,81,36,45,4,0502
پيرکاشان,0502048709,42,148,68,80,4,0502
جذر,0502048716,39,150,71,79,4,0502
دراب,0502048732,69,264,131,133,4,0502
روح اله,0502048739,9,37,23,14,4,0502
قشلاق امير محترم,0502048765,29,92,50,42,4,0502
قلعه فيروزاباد,0502048770,0,0,0,0,4,0502
گنداباد,0502048798,109,364,181,183,4,0502
کرم بست,0502048230,138,408,210,198,4,0502
بولان,0502048701,50,176,84,92,4,0502
حسن اباد,0502048725,15,53,21,32,4,0502
سرينجگه,0502048752,37,136,64,72,4,0502
مله شيخ,0502048807,51,174,84,90,4,0502
باقرابادميان رود,0502048699,11,36,18,18,4,0502
تمله,0502048712,24,93,40,53,4,0502
جبارابادسفلي,0502048714,47,148,73,75,4,0502
جبارابادعليا,0502048715,60,195,91,104,4,0502
کولان,0502048790,60,186,86,100,4,0502
ميانرود,0502048809,49,177,86,91,4,0502
هورتکه,0502048818,47,152,65,87,4,0502
رزلانسر,0502048737,50,189,88,101,4,0502
زين الدين,0502048741,95,288,141,147,4,0502
قره حسن,0502048762,97,347,162,185,4,0502
کمال اباد,0502048786,28,95,47,48,4,0502
گروران سفلي,0502048794,19,59,30,29,4,0502
موشاخان,0502048808,57,215,99,116,4,0502
حيدراباد,0502350875,0,0,0,0,4,0502
رزين,0502048738,277,952,472,480,4,0502
گروران عليا,0502048795,34,114,52,62,4,0502
علي اباد,0502048761,0,0,0,0,4,0502
کهريز,0502048791,136,483,233,250,4,0502
مرزباني,0502048800,136,432,195,237,4,0502
قزل,0502048763,30,79,32,47,4,0502
کمشور,0502048788,84,268,134,134,4,0502
سماق,0502048811,162,454,211,243,4,0502
ديزگران,0502048735,46,138,69,69,4,0502
قلعه لان,0502048771,54,148,72,76,4,0502
مزرعه مراداباد,0502048804,0,0,0,0,4,0502
هنياندر,0502048817,16,44,20,24,4,0502
هوکر,0502048819,24,83,39,44,4,0502
ده خران,0502352194,99,313,153,160,4,0502
ژاله رحمان بيگ,0503051258,0,0,0,0,4,0503
ژاله عثمان بيگ,0503051259,0,0,0,0,4,0503
ژاله قبادبيگ,0503051260,0,0,0,0,4,0503
انجيرک ايناغي,0503051262,0,0,0,0,4,0503
انجيرک زردويي,0503051263,0,0,0,0,4,0503
بانيه,0503051265,0,0,0,0,4,0503
باورول,0503051267,7,42,18,24,4,0503
پشت نيجه,0503051274,0,0,0,0,4,0503
داره رش,0503051277,0,0,0,0,4,0503
دگاسياب,0503051279,0,0,0,0,4,0503
دگاگا,0503051280,0,0,0,0,4,0503
دودان,0503051281,206,652,320,332,4,0503
زي,0503051289,0,0,0,0,4,0503
سيمان,0503051293,18,65,30,35,4,0503
شروله,0503051294,0,0,0,0,4,0503
گوريگور,0503051305,0,0,0,0,4,0503
لشگرگاه,0503051307,31,120,60,60,4,0503
لانوان,0503051312,0,0,0,0,4,0503
مره خيل,0503051313,0,0,0,0,4,0503
مره ماران,0503051315,0,0,0,0,4,0503
مزرعه ترگاران,0503051317,0,0,0,0,4,0503
مزرعه کيله کون,0503051321,0,0,0,0,4,0503
مزرعه موستان,0503051322,0,0,0,0,4,0503
مزرعه وزره,0503051323,0,0,0,0,4,0503
ورامچه,0503051331,0,0,0,0,4,0503
هرتا,0503051333,0,0,0,0,4,0503
امام زاده پير ميکان,0503805026,0,0,0,0,4,0503
زردويي,0503051287,207,743,403,340,4,0503
سفيداب,0503051291,26,87,43,44,4,0503
مزرعه حوض کوچ هوارگه,0503051318,0,0,0,0,4,0503
مزرعه رشکه پا,0503051320,0,0,0,0,4,0503
حضرت پير آقا مران,0503805027,0,0,0,0,4,0503
تين,0503051275,132,382,200,182,4,0503
مزرعه دواب,0503051797,0,0,0,0,4,0503
شرکان,0503051840,84,236,115,121,4,0503
مزرعه کوکين دشت,0503051848,0,0,0,0,4,0503
نروي,0503051851,137,424,218,206,4,0503
حجيج بزرگ,0503051833,106,321,164,157,4,0503
مزرعه گيلدان,0503051846,0,0,0,0,4,0503
بيدرواز,0503051831,42,123,63,60,4,0503
دزاور,0503051837,100,289,120,169,4,0503
کيمنه,0503051845,37,127,59,68,4,0503
هاني گرمله,0503051855,288,869,401,468,4,0503
تشار,0503051832,106,306,152,154,4,0503
حجيج کوچک,0503051834,0,0,0,0,4,0503
خانه دره,0503051836,0,0,0,0,4,0503
زبار,0503051838,4,11,9,2,4,0503
زلته,0503051839,0,0,0,0,4,0503
شوشمي سفلي,0503051841,0,0,0,0,4,0503
شوشمي عليا,0503051842,4,46,1,45,4,0503
شيخان,0503051843,0,0,0,0,4,0503
شينه,0503051844,0,0,0,0,4,0503
مزرعه بنرو,0503051847,0,0,0,0,4,0503
مزرعه هاني دشت,0503051849,0,0,0,0,4,0503
ميويه,0503051850,0,0,0,0,4,0503
نيسانه,0503051852,78,229,117,112,4,0503
وزلي,0503051853,42,115,55,60,4,0503
مزرعه هاني دوانه,0503051854,0,0,0,0,4,0503
حنان کر,0503351744,0,0,0,0,4,0503
هاني وز,0503353175,0,0,0,0,4,0503
دکل تلويزيوني مخابراتي,0503805028,0,0,0,0,4,0503
مزرعه تلاش اماميه سفلي,0504053235,0,0,0,0,4,0504
مزرعه تلاش اماميه عليا,0504053236,0,0,0,0,4,0504
اماميه سفلي,0504053237,225,732,366,366,4,0504
اماميه عليا,0504053238,136,569,288,281,4,0504
مزرعه چقاکدو,0504053257,0,0,0,0,4,0504
مزرعه املاک تلاش گنجوره,0504053231,0,0,0,0,4,0504
مزرعه بان ميران,0504053233,0,0,0,0,4,0504
مزرعه شوگه اماميه عليا,0504053248,0,0,0,0,4,0504
گنجوره,0504053254,141,518,254,264,4,0504
مزرعه يک شبه بان سفره,0504053258,0,0,0,0,4,0504
نجارگلين,0504053323,0,0,0,0,4,0504
مزرعه املاک تلاش,0504352974,0,0,0,0,4,0504
بر افتاب گلين,0504353159,31,96,47,49,4,0504
چمن,0504805031,6,26,13,13,4,0504
کلاوه,0504052251,118,406,184,222,4,0504
نرامان نقاره کوب,0504052257,131,490,250,240,4,0504
تنگ کوشک,0504351132,0,0,0,0,4,0504
پادگان ابوذر,0504052225,294,1076,493,583,4,0504
سراب قلعه شاهين,0504052237,207,664,316,348,4,0504
اسماندول,0505052496,14,37,21,16,4,0505
الياسان,0505052503,22,69,38,31,4,0505
بورک اباد,0505052509,32,119,52,67,4,0505
چشمه توران,0505052522,38,142,73,69,4,0505
چشمه قط,0505052524,25,78,45,33,4,0505
چشمه کبود,0505052526,0,0,0,0,4,0505
چهارملان,0505052532,22,73,35,38,4,0505
سيردوله,0505052562,30,95,43,52,4,0505
سيرکوه,0505052563,60,200,103,97,4,0505
علي اباد,0505052567,20,64,34,30,4,0505
کنده سرخ,0505052580,7,22,12,10,4,0505
تلخستان,0505052593,17,43,19,24,4,0505
چوب ساز,0505052516,0,0,0,0,4,0505
جوب کبودسفلي,0505052517,44,177,87,90,4,0505
جوب کبودعليا,0505052518,44,147,77,70,4,0505
چشمه بهاالدين,0505052521,49,170,86,84,4,0505
چشمه گيلان,0505052528,41,140,77,63,4,0505
چقور چاي,0505052530,24,85,43,42,4,0505
خليفه,0505052539,19,63,32,31,4,0505
دوگل بنده,0505052544,26,88,45,43,4,0505
ده شيخ,0505052548,49,173,75,98,4,0505
کل سفيد,0505052576,49,155,73,82,4,0505
مولان اباد,0505052592,10,37,22,15,4,0505
باباشيخ علي,0505052506,50,153,80,73,4,0505
امجدابادچشمه بري,0505052507,0,0,0,0,4,0505
چرخلان,0505052519,0,0,0,0,4,0505
چشمه قلعه,0505052525,10,31,18,13,4,0505
داشتي بلاغ,0505052542,99,311,158,153,4,0505
دربند,0505052543,25,100,48,52,4,0505
شوراباد,0505052564,148,500,247,253,4,0505
مزراله,0505052589,25,85,46,39,4,0505
قلعه حاج امين,0505052571,127,389,195,194,4,0505
تلمبه خانه شماره 2 نفت,0506052926,0,0,0,0,4,0506
تازه ابادگراوه,0506052929,29,95,49,46,4,0506
تنگاب نصراباد,0506052931,0,0,0,0,4,0506
تنگاب کهنه عباس,0506052932,4,63,0,63,4,0506
تنگابموسي گچي,0506052933,0,0,0,0,4,0506
تنگ آب خورشيد بگ,0506052934,0,0,0,0,4,0506
ايستگاه گام کوه,0506052938,0,0,0,0,4,0506
ني پهن سيفاله,0506052945,0,0,0,0,4,0506
ني پهن عبداله,0506052946,21,212,31,181,4,0506
امام حسن سفلي,0506053473,28,98,51,47,4,0506
امام حسن عليا,0506053474,19,63,28,35,4,0506
امام حسن وسطي,0506053475,32,103,53,50,4,0506
بان کنارجهانگير,0506053478,0,0,0,0,4,0506
بره بورانجيربان,0506053479,11,40,19,21,4,0506
کرکهرک,0506053506,103,317,161,156,4,0506
مزرعه بان قبرستان,0506053524,0,0,0,0,4,0506
گراوه اسماعيل,0506352966,45,155,81,74,4,0506
تازه اباد گراوه نمره 3,0506353124,0,0,0,0,4,0506
کارخانه اجرماشيني قوره تو,0506353127,0,0,0,0,4,0506
سيدسهراب,0506052937,27,83,39,44,4,0506
سيد سعيد,0506351956,85,262,133,129,4,0506
سليمان اباد,0507053020,103,365,189,176,4,0507
خرم اباد,0507053005,0,0,0,0,4,0507
دم بادام,0507053008,48,163,90,73,4,0507
رحمان اباد,0507053011,46,154,67,87,4,0507
شش يکان,0507053021,12,37,16,21,4,0507
فشخواران,0507053031,88,292,142,150,4,0507
گردکانه,0507053053,43,144,63,81,4,0507
داربسر,0507209083,14,44,21,23,4,0507
سراب,0507209087,7,17,9,8,4,0507
شکراب,0507209089,38,121,63,58,4,0507
هميانک,0507209109,19,59,26,33,4,0507
اب باريک,0507052987,31,107,51,56,4,0507
رشتيان,0507053015,50,159,83,76,4,0507
هزارخاني,0507053066,40,135,60,75,4,0507
همايون کش,0507053067,7,22,10,12,4,0507
زرده,0507209086,11,36,17,19,4,0507
حصار,0507053002,112,401,207,194,4,0507
عبدالتاجدين,0507053025,137,527,263,264,4,0507
بان تق,0508053477,0,0,0,0,4,0508
مزرعه پشته ماهي قوخان,0508053484,0,0,0,0,4,0508
پلکين,0508053485,0,0,0,0,4,0508
مزرعه تپه مير حسن,0508053487,0,0,0,0,4,0508
تورانشاه,0508053489,0,0,0,0,4,0508
جابرسفلي,0508053490,0,0,0,0,4,0508
سرتيتان,0508053497,33,100,50,50,4,0508
عليرضاوندي,0508053502,40,117,65,52,4,0508
مزرعه علامه,0508053504,0,0,0,0,4,0508
قاسم اباد,0508053505,57,190,92,98,4,0508
گاوميش چران عرب,0508053514,37,136,75,61,4,0508
مزرعه بره سيله,0508053525,0,0,0,0,4,0508
مزرعه رشمينه,0508053528,0,0,0,0,4,0508
مزرعه مهرعلي بزرگ,0508053533,0,0,0,0,4,0508
مزرعه مير صفي,0508053536,0,0,0,0,4,0508
مزرعه هره سرخ,0508053538,0,0,0,0,4,0508
ميروله علي اباد,0508351985,47,176,86,90,4,0508
رويبان بزرگ,0508351986,45,153,81,72,4,0508
تازه آباد رويبان,0508351987,26,75,38,37,4,0508
مزرعه مهرعلي کوچک,0508352051,0,0,0,0,4,0508
علي مراد سفلي,0508352916,0,0,0,0,4,0508
اوزين فريدون,0508053476,10,25,16,9,4,0508
کله پاي قاسم,0508053507,4,15,7,8,4,0508
کله جوب اسفندياري,0508053508,29,102,56,46,4,0508
گاومخل ايواني,0508053513,50,138,77,61,4,0508
مرجان بابامراد,0508053520,43,126,65,61,4,0508
مرجان قيطول,0508053521,71,233,122,111,4,0508
مرجان گمار,0508053522,56,182,84,98,4,0508
مزرعه بان صفر,0508053523,0,0,0,0,4,0508
مزرعه چرميان,0508053526,0,0,0,0,4,0508
مزرعه شاوک,0508053530,0,0,0,0,4,0508
داربلوط,0508351531,6,15,6,9,4,0508
دارتوت صيادي,0508351984,0,0,0,0,4,0508
مودرازحسين,0508352053,8,32,13,19,4,0508
دندانه,0508053495,66,228,110,118,4,0508
گورسفيد,0508053519,178,587,302,285,4,0508
ميرابه,0508053535,99,314,154,160,4,0508
به ابادصالح,0508053480,46,140,70,70,4,0508
به اباد قباسيايي,0508053481,11,37,15,22,4,0508
سياه گل,0508053498,48,171,92,79,4,0508
شيخ سرخ الدين عليا,0508053500,13,43,25,18,4,0508
کله جوب سفلي,0508053509,53,180,96,84,4,0508
کله جوب عليا,0508053510,44,155,77,78,4,0508
گنداب عليجان,0508053531,0,0,0,0,4,0508
ترشکيبان,0508053543,57,180,87,93,4,0508
کله جوب کياني,0508351745,21,76,41,35,4,0508
کله جوب کرمي,0508352968,17,59,29,30,4,0508
مزرعه محمد کساني نژاد,0508352970,9,34,20,14,4,0508
بينه گرد,0508053482,56,176,85,91,4,0508
شيخ سرخ الدين سفلي,0508053499,32,114,62,52,4,0508
گرازان سفلي,0508053515,39,150,82,68,4,0508
گرازان عليا,0508053516,53,157,78,79,4,0508
گراويان سفلي,0508053517,89,290,145,145,4,0508
دارتوت رحيم,0508351537,11,38,17,21,4,0508
مناف اباد,0508351746,16,53,27,26,4,0508
علي اباد,0508352969,9,29,17,12,4,0508
انجيردرميان,0508047629,4,13,4,9,4,0508
بره گينه,0508047633,5,16,8,8,4,0508
تولک,0508047634,23,81,36,45,4,0508
مزرعه چاله سياه,0508047635,9,32,15,17,4,0508
چشمه بطال,0508047636,7,22,11,11,4,0508
چشمه خاني,0508047637,27,88,48,40,4,0508
چشمه عيسي,0508047638,12,44,17,27,4,0508
زرور,0508047645,14,50,27,23,4,0508
پيکوله,0508047648,20,66,30,36,4,0508
شيخ جبرييل,0508047654,21,62,30,32,4,0508
کلک,0508047656,0,0,0,0,4,0508
ميان رود,0508047662,6,29,12,17,4,0508
باسکله بورويم,0508053406,42,167,79,88,4,0508
باسکله چشمه سفيد,0508053407,39,138,69,69,4,0508
باسکله خان ميرزا,0508053408,15,55,23,32,4,0508
باسکله وسط,0508053410,53,166,77,89,4,0508
باسکله درانبار,0508053409,88,340,170,170,4,0508
لته چقا,0508053429,163,620,304,316,4,0508
وارگه,0508053433,54,204,92,112,4,0508
بهرام بيگ,0508053411,30,100,48,52,4,0508
چشمه حاجگه,0508053416,106,399,204,195,4,0508
قلعه رمن,0508053425,84,315,154,161,4,0508
کرکول تعويضي,0508053426,86,261,134,127,4,0508
هفت چشمه جهانشاه,0508053434,32,101,46,55,4,0508
ايل شيرزادي,0508352967,21,75,40,35,4,0508
باقري,0508053371,0,0,0,0,4,0508
بيگ رضايي,0508053372,158,530,279,251,4,0508
ژاومرگ خليفه,0508053400,54,190,95,95,4,0508
ژاومرگ محمدمراد,0508053401,13,44,20,24,4,0508
ژاومرگ ناوخاص,0508053402,47,165,82,83,4,0508
احمدکشته داربادام,0508053403,0,0,0,0,4,0508
داربادام,0508053418,66,215,103,112,4,0508
درياب,0508053419,0,0,0,0,4,0508
چشمه غلامي,0508053414,102,331,164,167,4,0508
چشمه جادر,0508053415,50,179,82,97,4,0508
چشمه سفيدروتوند,0508053417,8,33,16,17,4,0508
سراب قنبر,0508053421,40,129,66,63,4,0508
صالحکه,0508053423,97,383,193,190,4,0508
طايفه رجب,0508053424,0,0,0,0,4,0508
کمره,0508053427,29,98,50,48,4,0508
چشمه سفيدوسين,0508351743,38,167,86,81,4,0508
راهداري قلاجه,0508805002,0,0,0,0,4,0508
درگه,0508053374,47,168,80,88,4,0508
سيدمحمدي,0508053375,0,0,0,0,4,0508
سيدنازه,0508053376,0,0,0,0,4,0508
مزرعه شيرزادي,0508053377,0,0,0,0,4,0508
طايفه خيدان,0508053378,4,14,6,8,4,0508
عليرضاوندي,0508053379,14,47,21,26,4,0508
باپيرسفلي,0508053412,5,15,6,9,4,0508
باپيرعليا,0508053413,0,0,0,0,4,0508
گرماب محمدرضاوندي,0508053428,41,169,78,91,4,0508
ميرمنگان سفلي,0508053431,34,109,47,62,4,0508
ميرمنگان عليا,0508053432,110,364,177,187,4,0508
باني لوان,0509051266,209,906,424,482,4,0509
پسه خور,0509051273,0,0,0,0,4,0509
دره ياب,0509051278,22,88,45,43,4,0509
دوروله بالا,0509051282,8,21,6,15,4,0509
دوروله پايين,0509051283,11,23,12,11,4,0509
دولتا,0509051285,79,309,164,145,4,0509
زاغه,0509051288,0,0,0,0,4,0509
قين سخت,0509051296,4,15,5,10,4,0509
کاني سالار,0509051298,11,23,10,13,4,0509
کلور,0509051300,30,96,48,48,4,0509
کله,0509051301,11,28,11,17,4,0509
کولسه امين,0509051304,0,0,0,0,4,0509
مره تا,0509051338,17,68,32,36,4,0509
ايمان,0509352950,5,10,5,5,4,0509
قلاجي,0509051297,148,592,287,305,4,0509
مزران,0509051314,78,308,139,169,4,0509
مله رش,0509051326,52,199,100,99,4,0509
ميرعبدلي سفلي,0509051328,18,70,35,35,4,0509
ميرعبدلي عليا,0509051329,11,47,23,24,4,0509
قلعه گاه,0509352046,0,0,0,0,4,0509
گوزه,0509352047,0,0,0,0,4,0509
لاقلا,0509352048,21,91,45,46,4,0509
بايل,0509051268,0,0,0,0,4,0509
پاوناران,0509051271,25,87,43,44,4,0509
امام زاده چم ژاله,0509051276,0,0,0,0,4,0509
کلاش هوش,0509051303,119,488,234,254,4,0509
لمه,0509051308,8,40,19,21,4,0509
لولم,0509051309,149,570,279,291,4,0509
مره مير,0509051316,0,0,0,0,4,0509
مزرعه ده کهن,0509051319,0,0,0,0,4,0509
کلاش قوه,0509051302,53,219,121,98,4,0509
گويله,0509051306,34,141,73,68,4,0509
مله دشتي,0509051325,0,0,0,0,4,0509
دستجرده عليا,0510048127,27,86,45,41,4,0510
چمه,0510048379,161,535,270,265,4,0510
دستجرده سفلي,0510048380,114,383,186,197,4,0510
کاکاوند,0510048387,0,0,0,0,4,0510
محمدابادبانمله,0510048393,6,16,9,7,4,0510
دوآبان,0510048395,0,0,0,0,4,0510
ميرطاهر,0510048397,29,94,50,44,4,0510
چالاب قجر,0510352186,0,0,0,0,4,0510
امام زاده اله,0510805024,0,0,0,0,4,0510
مرزعه عزيز اباد,0510805025,0,0,0,0,4,0510
جيحون اباد,0510048377,301,872,437,435,4,0510
بابا کمال,0510048179,50,168,86,82,4,0510
چراغ اباد,0510048191,36,105,51,54,4,0510
ينگيجه,0510048250,66,216,118,98,4,0510
احمداباد,0510048370,73,222,117,105,4,0510
کرج,0510048390,63,195,102,93,4,0510
مريمنگار,0510048394,26,73,38,35,4,0510
بابا کمال عليا,0510805023,11,37,18,19,4,0510
اميراباد,0510048176,26,69,30,39,4,0510
بالاجوب,0510048180,111,379,193,186,4,0510
تعاوني 46,0510048187,0,0,0,0,4,0510
زيباجوب,0510048208,94,316,156,160,4,0510
شاهمار,0510048215,42,137,72,65,4,0510
قيطاس اباد,0510048386,73,236,121,115,4,0510
مزرعه عالي سياه,0510352926,0,0,0,0,4,0510
خدراباد,0510048201,34,107,59,48,4,0510
ده خانجان,0510048205,20,67,30,37,4,0510
طاهراباد,0510048219,154,540,272,268,4,0510
کله جوب درتنگ,0510048232,51,154,76,78,4,0510
عزيزاباد,0510048385,51,172,87,85,4,0510
کارخانه دانه بندي شن,0510351777,0,0,0,0,4,0510
امين اباد,0510048177,50,158,78,80,4,0510
پيرقاسم,0510048183,6,19,11,8,4,0510
حسن ابادسفلي,0510048199,81,278,143,135,4,0510
حسن ابادعليا,0510048200,31,95,47,48,4,0510
سيدشهاب,0510048213,25,80,37,43,4,0510
قلعه دهخانجان,0510048226,22,71,37,34,4,0510
گيلانه,0510048241,77,223,110,113,4,0510
ارمني جان,0510048171,156,516,256,260,4,0510
رشيداباد,0510048206,25,76,37,39,4,0510
سفيدخاني,0510048210,13,44,24,20,4,0510
شيرخان,0510048218,51,145,78,67,4,0510
کرکسار,0510048231,61,253,160,93,4,0510
کله جوب عليا,0510048233,27,82,38,44,4,0510
هريله,0510048249,17,63,27,36,4,0510
احمد اباد مله ماس,0510048371,25,85,44,41,4,0510
جباراباد,0510048376,31,96,44,52,4,0510
ده اسياب,0510048381,29,78,39,39,4,0510
مزرعه نظراباد,0510048396,0,0,0,0,4,0510
محموداباد,0510048398,16,33,19,14,4,0510
مزرعه دولت اباد,0510352925,0,0,0,0,4,0510
تينموسفلي,0510048374,36,133,68,65,4,0510
تينموعليا,0510048375,28,71,37,34,4,0510
گونبان,0510048392,36,130,62,68,4,0510
اسلام ابادسفلي,0510048136,134,419,212,207,4,0510
هالان,0510048146,60,207,93,114,4,0510
بکترسفلي,0510048372,25,59,32,27,4,0510
بکترعليا,0510048373,24,73,39,34,4,0510
پيرسراب,0510048125,12,25,13,12,4,0510
حسين اباد,0510048126,26,100,45,55,4,0510
دواب,0510048128,6,19,9,10,4,0510
عزيزاباد,0510048132,16,63,26,37,4,0510
مزرعه قشلاق وسطي,0510048134,0,0,0,0,4,0510
دهلقين,0510048143,100,326,157,169,4,0510
مزرعه قشلاق سفلي,0510048144,0,0,0,0,4,0510
منجق تپه,0510048145,21,61,25,36,4,0510
سماقستان سفلي,0510048383,0,0,0,0,4,0510
سماقستان عليا,0510048384,0,0,0,0,4,0510
کپرگه,0510048388,0,0,0,0,4,0510
گلم کبود,0510048391,10,33,17,16,4,0510
سردهلق,0510048131,33,108,52,56,4,0510
قشلاق عليا,0510048133,32,128,62,66,4,0510
کريم اباد,0510048135,14,50,24,26,4,0510
اسلام ابادعليا,0510048137,46,136,80,56,4,0510
گرگلان,0510048138,42,140,59,81,4,0510
گرگه بيشه سفلي,0510048139,14,42,18,24,4,0510
گرگه بيشه عليا,0510048140,16,64,30,34,4,0510
کل گدار,0510048141,13,51,25,26,4,0510
مزرعه دهلق بالا,0510048142,0,0,0,0,4,0510
همت اباد,0510048147,14,62,31,31,4,0510
چشمه بيگي,0511050352,53,194,100,94,4,0511
شمس اباد,0511050379,21,85,42,43,4,0511
عزيزاباد,0511050381,72,238,125,113,4,0511
قلعه محمدعلي,0511050384,46,162,80,82,4,0511
گرميانک,0511050394,67,231,121,110,4,0511
پشت تنگ چناران,0511050345,9,37,15,22,4,0511
سرماج کرمي,0511050372,13,46,24,22,4,0511
سيردوله,0511050376,24,88,45,43,4,0511
شادابادسفلي,0511050377,79,247,122,125,4,0511
شادابادعليا,0511050378,61,218,105,113,4,0511
علي اباد,0511050382,34,125,64,61,4,0511
انجيرک,0511050334,15,62,25,37,4,0511
سرانجيرک,0511050368,36,153,71,82,4,0511
قمليجه,0511050385,28,104,49,55,4,0511
کلکوشوندعليا,0511050388,34,160,76,84,4,0511
کلکوشوندوسطي,0511050389,28,117,57,60,4,0511
کلکوشوندسفلي,0511050390,17,66,26,40,4,0511
قلي اباد,0511050411,45,168,83,85,4,0511
بابازيد,0511050335,137,506,248,258,4,0511
چشمه مهدي,0511050354,10,35,19,16,4,0511
سعدوندسفلي,0511050373,22,82,34,48,4,0511
سعد وند عليا,0511050374,55,203,95,108,4,0511
الياسوندسفلي,0511050332,66,236,118,118,4,0511
الياسوندعليا,0511050333,53,207,106,101,4,0511
سنجابيدرايگان,0511050375,62,211,97,114,4,0511
صوفي وند,0511050380,38,162,77,85,4,0511
چقاسعيد,0511050355,148,531,279,252,4,0511
داودي سفلي,0511050361,38,123,54,69,4,0511
داودي عليا,0511050362,27,96,44,52,4,0511
مزرعه علي اباد,0511050383,0,0,0,0,4,0511
کهريزعليا,0511050392,70,260,124,136,4,0511
مزرعه خرخر,0511050400,0,0,0,0,4,0511
کاهرنگي,0511050402,0,0,0,0,4,0511
مزرعه کهريزسفلي,0511050403,0,0,0,0,4,0511
مزرعه ميان تنگ سفلي,0511050404,0,0,0,0,4,0511
مزرعه ميان تنگ عليا,0511050405,0,0,0,0,4,0511
مزرعه ميان تنگ وسطي,0511050406,0,0,0,0,4,0511
پريوه عليا,0511350333,34,128,63,65,4,0511
شهرک صنعتي,0511805009,0,0,0,0,4,0511
سراباديه سفلي,0511047919,79,276,130,146,4,0511
سراباديه عليا,0511047920,21,67,33,34,4,0511
حسن بقعه,0511050360,34,126,63,63,4,0511
زازم سفلي,0511050365,40,151,78,73,4,0511
زازم عليا,0511050366,20,58,29,29,4,0511
قلعه جوق,0511050401,4,9,5,4,4,0511
مله حسن بقعه,0511050407,38,119,61,58,4,0511
مله ولي,0511050408,27,95,44,51,4,0511
چقاکبود,0511050356,30,108,52,56,4,0511
قيسوند,0511050386,94,312,152,160,4,0511
پريوه سفلي,0511050343,216,819,397,422,4,0511
علي آباد حاتمي,0511805030,11,50,26,24,4,0511
انار,0512050790,0,0,0,0,4,0512
بستان اباد,0512050802,30,130,64,66,4,0512
تله توت,0512050819,7,23,15,8,4,0512
جنگله سفلي,0512050824,0,0,0,0,4,0512
جنگله عليا,0512050825,10,34,17,17,4,0512
چهارديوار,0512050838,6,22,10,12,4,0512
خورنين,0512050853,0,0,0,0,4,0512
دواب چم خرطلا,0512050865,0,0,0,0,4,0512
گرم دره,0512050938,0,0,0,0,4,0512
کريشه سفلي,0512050939,0,0,0,0,4,0512
مزرعه قجر,0512050953,5,18,9,9,4,0512
مزرعه قلقله سفلي,0512050954,0,0,0,0,4,0512
مزرعه کريشه عليا,0512050955,0,0,0,0,4,0512
هاله سياه,0512050978,0,0,0,0,4,0512
گوگاه,0512352098,18,65,29,36,4,0512
ايينه وند,0512046664,13,57,27,30,4,0512
پالان نرگس,0512046674,27,123,57,66,4,0512
کاني مصطفي بيگ,0512046697,32,106,44,62,4,0512
قوله رش والي سبزه,0512352192,49,207,96,111,4,0512
سهراب عزيزي,0512352295,0,0,0,0,4,0512
چم لمه عثمان,0512352297,44,190,99,91,4,0512
ده عباس,0512352961,8,42,22,20,4,0512
چم زرشک اسپري,0512352962,57,222,115,107,4,0512
چم زرشک چقاويان,0512352963,19,74,37,37,4,0512
قمان خدا نظر,0512805003,4,17,9,8,4,0512
بان لوريان رحيم,0512046665,0,0,0,0,4,0512
پالان عليا,0512046673,64,238,108,130,4,0512
چم زرشک عليا,0512046677,251,988,511,477,4,0512
حسن گاويار,0512046679,0,0,0,0,4,0512
پالان سفلي,0512046688,42,193,98,95,4,0512
مزرعه سفره بانو,0512046690,0,0,0,0,4,0512
مرزلان محمدمراد,0512046698,30,109,51,58,4,0512
چم زرشک سفلي,0512046676,17,73,40,33,4,0512
تنگه ويشه,0512050821,0,0,0,0,4,0512
جوجار دشتي حر,0512050826,36,141,66,75,4,0512
درنه,0512050859,0,0,0,0,4,0512
دواب,0512050866,0,0,0,0,4,0512
قلقله,0512050914,225,839,401,438,4,0512
کاني بي خير,0512050917,17,55,32,23,4,0512
ميدان طفلي,0512050965,23,87,43,44,4,0512
ميدانه,0512050968,0,0,0,0,4,0512
مزرعه گره کبود مالک اشتر,0512805011,6,31,14,17,4,0512
انجير بوس بالا,0512050791,0,0,0,0,4,0512
انجير بوس پايين,0512050792,13,49,25,24,4,0512
تازه ابادامين,0512050810,52,179,92,87,4,0512
زيارت تمرخان,0512050880,193,767,386,381,4,0512
کاني دانيال,0512050920,34,149,72,77,4,0512
مزرعه تازه آباد عبدالقادر,0512050948,0,0,0,0,4,0512
مزرعه ده مجنون,0512050951,0,0,0,0,4,0512
مزرعه گوگرد,0512050956,28,111,55,56,4,0512
پل علي اکبرخان,0512352193,14,71,34,37,4,0512
باباشاه احمد,0513046809,22,100,53,47,4,0513
بريه خاني,0513046826,36,141,65,76,4,0513
سراب سيد يعقوب,0513046855,8,30,14,16,4,0513
صفرشاه,0513046881,65,205,104,101,4,0513
کبودجوب عليا,0513046893,0,0,0,0,4,0513
گوراجوب زيدعلي,0513046905,10,30,17,13,4,0513
گوراجوب قشلاق,0513046906,19,57,29,28,4,0513
گوراجوب باباکرم,0513046907,21,71,40,31,4,0513
گوراجوب مرادبيگ,0513046908,0,0,0,0,4,0513
نيلک,0513046921,53,190,101,89,4,0513
ويله,0513046923,18,71,34,37,4,0513
هيورود,0513046924,21,53,30,23,4,0513
مجتمع گاو شيري گهواره,0513805019,0,0,0,0,4,0513
بان نخود,0513046819,13,58,31,27,4,0513
بان ياران اميرحق مراد,0513046820,22,75,42,33,4,0513
بان ياران عزيزمراد,0513046822,15,51,25,26,4,0513
بيموش,0513046830,62,206,112,94,4,0513
ترکه سفلي,0513046844,4,12,4,8,4,0513
توتشامي,0513046845,85,312,163,149,4,0513
جاماسب,0513046847,5,12,6,6,4,0513
چقاچوبين,0513046856,50,180,90,90,4,0513
خله کوش سفلي,0513046857,0,0,0,0,4,0513
خله کوش عليا,0513046858,4,13,8,5,4,0513
خليفه ها,0513046859,9,30,14,16,4,0513
درگه,0513046863,42,161,85,76,4,0513
زوله,0513046872,5,15,7,8,4,0513
گل انجير,0513046904,20,76,43,33,4,0513
قلعه قاضي پشت بند,0513046833,21,88,48,40,4,0513
توکان,0513046846,19,61,32,29,4,0513
چغا بور دارابي,0513046848,28,75,42,33,4,0513
چغابوررحمان,0513046849,22,76,41,35,4,0513
چغابورعيسي,0513046850,5,16,8,8,4,0513
چغابورکاکي,0513046851,19,61,26,35,4,0513
روکوان,0513046869,8,26,13,13,4,0513
سراسياب,0513046873,5,16,8,8,4,0513
عليکه,0513046885,12,43,22,21,4,0513
قلعه قاضي سفلي,0513046889,29,121,64,57,4,0513
قلعه قاضي عليا,0513046890,0,0,0,0,4,0513
کچکبل سفلي,0513046895,21,73,39,34,4,0513
کچکبل عليا,0513046896,45,140,69,71,4,0513
کنه رشيد الگه,0513046899,12,49,24,25,4,0513
کنه رشيدباباخان,0513046900,10,29,16,13,4,0513
کنه رشيدعرب,0513046902,15,46,29,17,4,0513
کنه رشيدگل مراد,0513046903,15,45,24,21,4,0513
مزرعه ترکه عليا,0513046911,0,0,0,0,4,0513
همه اياز,0513046915,0,0,0,0,4,0513
مله کبود,0513046917,28,109,54,55,4,0513
نرژي,0513046920,13,55,28,27,4,0513
کنه رشيدذغال دان,0513350053,0,0,0,0,4,0513
بان زلاني عليا,0513046812,38,133,67,66,4,0513
بان سوله شيرزاد,0513046814,5,15,9,6,4,0513
تازه ابادپشت تنگ شاهمار,0513046834,0,0,0,0,4,0513
تختگاه صورت خانم,0513046840,20,63,33,30,4,0513
تختگاه جهانبخش,0513046841,55,168,89,79,4,0513
تختگاه حسين سلطان,0513046843,56,179,93,86,4,0513
سرتختکا,0513046874,45,140,73,67,4,0513
شاه ماربابامراد,0513046878,20,77,35,42,4,0513
شاه مارميرزامراد,0513046879,76,277,136,141,4,0513
کلينه,0513046898,32,106,55,51,4,0513
چشمه سفيد,0513350051,14,35,22,13,4,0513
بان زلاني سفلي,0513351763,11,40,17,23,4,0513
تختگاه صفي سلطان,0513353098,16,73,33,40,4,0513
اجاق قلي,0513046624,0,0,0,0,4,0513
اسياب تنوره,0513046625,36,106,51,55,4,0513
بيامه,0513046626,8,25,12,13,4,0513
پادگان امام خميني,0513046627,0,0,0,0,4,0513
چالاب يارقلي,0513046628,0,0,0,0,4,0513
چقاميرگه,0513046629,0,0,0,0,4,0513
ده جامي,0513046630,58,209,97,112,4,0513
ده کهنه,0513046631,41,135,70,65,4,0513
ده لطيفه,0513046632,0,0,0,0,4,0513
ريساني,0513046633,17,43,22,21,4,0513
سرتنگ,0513046634,48,157,89,68,4,0513
سيدباقر,0513046635,7,27,14,13,4,0513
شيخ حسن,0513046636,7,29,14,15,4,0513
کنه هر,0513046637,60,194,104,90,4,0513
مزرعه رستم علي,0513046638,0,0,0,0,4,0513
قوشچي باشي,0513046639,0,0,0,0,4,0513
مزرعه گرگه چقا,0513046640,0,0,0,0,4,0513
مملي کلاشي,0513046641,0,0,0,0,4,0513
ويله,0513046642,33,106,48,58,4,0513
مزرعه رضاعلي,0513350078,0,0,0,0,4,0513
تازه ابادسرياس,0514051426,195,685,333,352,4,0514
چلانه عليا,0514051432,53,206,99,107,4,0514
چلانه سفلي,0514051436,0,0,0,0,4,0514
قلعه گاه,0514051466,31,121,76,45,4,0514
مزرعه تبرگزين,0514051492,0,0,0,0,4,0514
بير داد,0514047244,7,26,12,14,4,0514
تپه زرد,0514047252,33,108,50,58,4,0514
دامداري قلعه ذکريا,0514047278,0,0,0,0,4,0514
عمراباد,0514047310,23,78,35,43,4,0514
قلعه ذکريا,0514047315,63,217,105,112,4,0514
گرگابي مصطفي,0514047333,0,0,0,0,4,0514
گرگابي ميرزاعلي,0514047334,22,64,32,32,4,0514
تم تم,0514051630,39,132,70,62,4,0514
ده ساده,0514051644,24,79,42,37,4,0514
مزرعه ده سرخ,0514051684,0,0,0,0,4,0514
مزرعه ده رش,0514352095,0,0,0,0,4,0514
مرکز خدمات قلعه ذکريا,0514352940,0,0,0,0,4,0514
گرازاباد,0514047332,48,146,68,78,4,0514
تپه رش,0514051627,35,110,55,55,4,0514
تپه کوييک,0514051628,66,220,104,116,4,0514
حسين اباد,0514051634,6,21,11,10,4,0514
ده باغ,0514051642,12,36,15,21,4,0514
شالي اباد,0514051651,17,51,24,27,4,0514
قلعه رضا,0514051656,13,38,22,16,4,0514
کريم اباد,0514051663,30,98,48,50,4,0514
گيج,0514051672,20,64,36,28,4,0514
مزرعه خاني اباد,0514051683,0,0,0,0,4,0514
مزرعه کلاه اباد,0514051689,0,0,0,0,4,0514
شرکت کشاورزي و دامپروري حسن آباد,0514351752,54,189,100,89,4,0514
ميرعزيزي,0514352096,26,86,41,45,4,0514
اسماعيل کل,0514047233,20,74,35,39,4,0514
جانجان,0514047255,20,77,41,36,4,0514
حاجي اباد,0514047271,21,88,53,35,4,0514
دواب,0514047281,42,155,74,81,4,0514
شوربلاغ,0514047303,46,165,80,85,4,0514
غلامعلي بيگ,0514048478,0,0,0,0,4,0514
کاني شريف,0514048532,53,196,97,99,4,0514
تپه لري,0514051629,65,215,101,114,4,0514
گوريان گورا,0514051671,26,82,39,43,4,0514
اهنگران,0514048459,23,84,37,47,4,0514
بزاولي,0514048463,0,0,0,0,4,0514
سمنگان,0514048516,22,76,38,38,4,0514
باباحيران,0514051616,8,28,12,16,4,0514
چشمه پنبه,0514051631,16,69,33,36,4,0514
خرم ابادسفلي,0514051638,126,458,217,241,4,0514
خرم ابادعليا,0514051639,58,220,103,117,4,0514
کلاه کبود,0514051665,60,228,106,122,4,0514
مزرعه حلاج اباد,0514051682,0,0,0,0,4,0514
مزرعه شريف,0514051687,0,0,0,0,4,0514
شهرک صنعتي روانسر,0514353150,7,23,11,12,4,0514
مجتمع شيميايي بيستون,0514805016,0,0,0,0,4,0514
حسن اباد,0514051633,257,924,425,499,4,0514
زرين چقا,0514051645,58,223,118,105,4,0514
خمارتاج,0501047710,50,155,76,79,4,0501
گراوند,0501047725,263,845,407,438,4,0501
سراب هرسم,0501047715,116,383,199,184,4,0501
قلعه هرسم,0501047721,111,368,195,173,4,0501
بازگه,0501047700,29,85,42,43,4,0501
باقراباد,0501047701,19,56,29,27,4,0501
تازه اباد,0501047702,21,65,29,36,4,0501
ري بلک سفلي,0501047713,29,100,49,51,4,0501
علي ابادديزگران,0501047718,47,186,100,86,4,0501
گردي,0501047726,20,72,41,31,4,0501
منوري,0501047735,23,85,38,47,4,0501
ويسگه,0501047737,35,132,70,62,4,0501
رضااباد,0501047711,0,0,0,0,4,0501
ري بلک عليا,0501047714,44,151,79,72,4,0501
شادبلاغ,0501047716,75,280,137,143,4,0501
قلعه ترک سفلي,0501047719,24,77,43,34,4,0501
قلعه ترک عليا,0501047720,38,146,75,71,4,0501
مله هار,0501047734,69,251,115,136,4,0501
هشت جفته,0501047738,26,84,41,43,4,0501
باريکه نظام عليا,0501047699,108,358,178,180,4,0501
تولابي,0501047703,116,371,176,195,4,0501
چهارده جفته,0501047707,78,276,140,136,4,0501
باريکه صادقي,0501047698,43,152,75,77,4,0501
تپه گله سفلي,0501046838,33,138,69,69,4,0501
تپه گله عليا,0501046839,70,277,136,141,4,0501
عاشقان عابدين,0501046883,15,53,24,29,4,0501
عاشقان موسي,0501046884,44,162,78,84,4,0501
مله اميرخان,0501046916,13,47,26,21,4,0501
خاوکه,0501047600,0,0,0,0,4,0501
سرخک,0501047601,116,409,206,203,4,0501
تالاني,0501047607,23,74,42,32,4,0501
سيماني سفلي,0501046876,10,36,21,15,4,0501
سيماني عليا,0501046877,8,40,15,25,4,0501
چنار,0501047599,57,208,99,109,4,0501
بره سيله,0501047103,82,361,163,198,4,0501
برزه,0501047595,66,252,140,112,4,0501
جليلوند,0501047596,10,37,21,16,4,0501
چشمه هلنگ,0501047597,11,48,29,19,4,0501
چفته,0501047598,50,204,96,108,4,0501
سوران سفلي,0501047602,22,81,37,44,4,0501
سوران عليا,0501047603,43,156,76,80,4,0501
مزرعه سيل يعقوب برزه,0501047606,0,0,0,0,4,0501
ولکه وند,0501047608,54,203,103,100,4,0501
چنگرجليلوند,0501047125,188,684,332,352,4,0501
چنگرسمينوند,0501047126,112,423,227,196,4,0501
مزرعه تک تک ويس علي,0501047604,0,0,0,0,4,0501
مزرعه جليلوندوناب,0501047605,0,0,0,0,4,0501
چقازرد چوپانکاره,0501047122,234,844,428,416,4,0501
سراب خمان,0501047131,100,392,207,185,4,0501
پشت تنگ شاه ميرزا,0502049432,14,48,21,27,4,0502
زينلان سفلي,0502049447,15,62,30,32,4,0502
زينلان عليا,0502049448,7,30,17,13,4,0502
مستعلي سفلي,0502049475,7,26,13,13,4,0502
مستعلي عليا,0502049476,67,279,143,136,4,0502
هزارخاني,0502049485,6,27,12,15,4,0502
انارک,0502049425,10,36,20,16,4,0502
انارک سفلي,0502049426,11,52,24,28,4,0502
انارک عليا,0502049427,29,111,48,63,4,0502
پلسک تپه,0502049429,5,20,8,12,4,0502
پشتاله,0502049431,6,21,8,13,4,0502
پشت کبودجهانگيروند,0502049433,50,209,111,98,4,0502
توه امن شينه,0502049435,30,132,69,63,4,0502
جوجار,0502049436,4,21,7,14,4,0502
خرونان,0502049441,8,44,21,23,4,0502
دره دوزخ,0502049443,25,95,45,50,4,0502
مزرعه ديون,0502049444,29,127,62,65,4,0502
زردشيخ حسن,0502049445,7,28,17,11,4,0502
زيرچقاموسي,0502049446,0,0,0,0,4,0502
گل جيران,0502049460,6,35,17,18,4,0502
مزرعه ميدان حياسوند,0502049474,26,108,51,57,4,0502
ميدان حاجي محمد خاني,0502049480,0,0,0,0,4,0502
مزرعه ورداران طلاسه,0502049482,0,0,0,0,4,0502
مزرعه ميدان حاجي محمدخان,0502351043,0,0,0,0,4,0502
پلکانه,0502351796,26,126,58,68,4,0502
سيد يل,0502353013,12,45,22,23,4,0502
چشمه شاهرخ مسگره,0502049440,22,88,45,43,4,0502
سراب سرين,0502049449,57,221,101,120,4,0502
سلاطين,0502049452,20,85,42,43,4,0502
سيد حسن,0502049453,0,0,0,0,4,0502
شير خان,0502049454,4,17,7,10,4,0502
شينه,0502049455,14,45,19,26,4,0502
کلاک بايه,0502049458,0,0,0,0,4,0502
گليل,0502049461,36,147,74,73,4,0502
گيه در,0502049462,11,50,23,27,4,0502
مزرعه خرونان,0502049465,0,0,0,0,4,0502
سرخه دره,0502049468,7,30,15,15,4,0502
مزرعه سلاطين,0502049469,0,0,0,0,4,0502
گرگاوان,0502049470,25,97,47,50,4,0502
مزرعه گليل,0502049471,0,0,0,0,4,0502
مزرعه گيه در,0502049472,0,0,0,0,4,0502
مسگره,0502049477,26,100,47,53,4,0502
مزرعه مسگره بالا,0502049478,0,0,0,0,4,0502
مولي,0502049479,13,58,27,31,4,0502
نامدار,0502049481,10,38,17,21,4,0502
وينه,0502351041,36,151,83,68,4,0502
ورداران طلاسه,0502351042,0,0,0,0,4,0502
مزرعه دورگين,0502353015,0,0,0,0,4,0502
اشباخ,0502049424,141,471,214,257,4,0502
جهانگيروند,0502049437,78,296,141,155,4,0502
خشکه رودحسين,0502049442,0,0,0,0,4,0502
سرجوب قلعه مسگره,0502049450,42,160,79,81,4,0502
کل کوشک,0502049457,12,43,20,23,4,0502
وزم خشکه رود,0502049483,10,32,14,18,4,0502
پاقلعه خشکه رود,0502351044,10,40,22,18,4,0502
سراييلان توه خاکي,0502351797,0,0,0,0,4,0502
سرجوب عثمانوند,0502805029,32,126,66,60,4,0502
انجاب بوژان,0502049428,65,275,145,130,4,0502
چشمه خيره فيروزان,0502049438,0,0,0,0,4,0502
چشمه سرخ,0502049439,20,87,42,45,4,0502
قادرمرز,0502049456,8,35,20,15,4,0502
کمراباد,0502049459,0,0,0,0,4,0502
مزرعه تلخستان,0502049463,0,0,0,0,4,0502
بزه رشستان گل زرد,0502049464,0,0,0,0,4,0502
مزرعه سرگول,0502352903,0,0,0,0,4,0502
استداباد,0502049216,23,90,49,41,4,0502
پايروندتکيه,0502049231,5,23,11,12,4,0502
علي اکبر,0502049277,68,233,110,123,4,0502
فرامان,0502049279,45,187,87,100,4,0502
کاورلوان,0502049285,106,389,177,212,4,0502
گله جار,0502049304,50,197,104,93,4,0502
نيمدانگي,0502049316,8,37,20,17,4,0502
بزگدارسفلي,0502049227,41,152,75,77,4,0502
بزگدارعليا,0502049228,129,530,249,281,4,0502
قلعه قباد,0502049280,34,119,55,64,4,0502
قمشه,0502049281,107,397,199,198,4,0502
خلخال,0502049244,23,87,39,48,4,0502
زنگي چقا,0502049252,44,148,81,67,4,0502
کراني سفلي,0502049288,128,417,212,205,4,0502
کراني عليا,0502049289,44,149,71,78,4,0502
کراني هاشم سلطان,0502049290,23,68,28,40,4,0502
مزرعه برافتاب,0502049309,12,38,16,22,4,0502
چال قنبر,0502049310,0,0,0,0,4,0502
ميرزاکوسه,0502049314,10,43,19,24,4,0502
تپه شعبان,0502049234,45,162,69,93,4,0502
ده کبود,0502049249,114,384,196,188,4,0502
شاه ملکي,0502049269,119,403,192,211,4,0502
سليمانيه,0502049259,268,921,439,482,4,0502
گاو پناه,0502049300,106,366,172,194,4,0502
حاجي اباد,0502049240,101,375,156,219,4,0502
سرارودسفلي,0502049254,143,466,228,238,4,0502
سرارودعليا,0502049255,9,39,17,22,4,0502
ايستگاه تقويت موبايل,0502352910,0,0,0,0,4,0502
پادگان نظامي,0502352854,0,0,0,0,4,0502
پادگان نظامي حاجي اباد,0502353024,28,1230,46,1184,4,0502
خانه هاي سازماني پادگان,0502353025,197,674,328,346,4,0502
رحيم اباد,0502049250,144,479,243,236,4,0502
سه چک,0502049264,120,417,210,207,4,0502
سيمان غرب,0502049267,21,64,32,32,4,0502
چال آباد,0502049155,88,782,138,644,4,0502
گاکيه,0502049169,144,477,229,248,4,0502
باغ فلک,0502049223,13,44,19,25,4,0502
توبره ريز,0502049235,110,422,220,202,4,0502
پادگان شهيد بروجردي,0502351814,0,0,0,0,4,0502
پادگان توحيد,0502353138,0,0,0,0,4,0502
شهرک صنعتي فرامان,0502353146,58,167,67,100,4,0502
پادگان شهيد معطري,0502353154,12,144,15,129,4,0502
پادگان نبوت,0502805007,0,0,0,0,4,0502
پادگان امامت,0502805008,0,0,0,0,4,0502
پادگان نبي اکرم,0502049147,0,0,0,0,4,0502
سياه بيدعليا,0502049161,261,921,424,497,4,0502
پادگان هوانيروز,0502049148,556,2403,977,1426,4,0502
سياه بيدسفلي,0502049160,284,1062,507,555,4,0502
بيجانه,0502049146,198,714,369,345,4,0502
حصارسفيد,0502049243,59,220,105,115,4,0502
منوچهراباد,0502049312,152,593,287,306,4,0502
موريان,0502049313,43,156,80,76,4,0502
ساتياري,0503051290,179,598,305,293,4,0503
اريت,0503051261,44,155,81,74,4,0503
بله اي,0503051270,0,0,0,0,4,0503
پايگاه شهيدصدوقي,0503051272,0,0,0,0,4,0503
مزرعه دول بران,0503051284,0,0,0,0,4,0503
کاني سفيد,0503051299,0,0,0,0,4,0503
لاران عليا,0503051310,42,148,74,74,4,0503
لاران سفلي,0503051311,40,141,65,76,4,0503
مزيدي,0503051324,55,170,91,79,4,0503
ميرعبدلي زرين چيا,0503051327,141,555,304,251,4,0503
ميوان,0503051330,45,153,84,69,4,0503
سرياس,0503351865,212,723,341,382,4,0503
درمور,0503051787,4,10,6,4,4,0503
گلال,0503051796,176,619,302,317,4,0503
نورياب,0503051802,434,1447,759,688,4,0503
بله بزان,0503051781,0,0,0,0,4,0503
دريوه,0503051789,0,0,0,0,4,0503
کمادره,0503051795,13,43,22,21,4,0503
مزرعه طلوکي,0503051798,0,0,0,0,4,0503
ملاندر,0503051799,4,19,2,17,4,0503
نجار,0503051800,52,161,82,79,4,0503
ورا,0503051803,91,423,138,285,4,0503
هيروي,0503051804,19,54,35,19,4,0503
داريان,0503051786,168,541,263,278,4,0503
تيني,0504052108,23,85,40,45,4,0504
شمشيرداره رشيد,0504052120,48,203,97,106,4,0504
مجيدقلعه پرور,0504052147,12,44,19,25,4,0504
بازگيرقلعه پرور,0504052094,86,308,154,154,4,0504
پيران,0504052102,107,349,190,159,4,0504
سلمان تپه,0504052119,26,86,44,42,4,0504
کاني عزيز,0504052132,27,99,49,50,4,0504
مله کبود,0504052149,16,57,29,28,4,0504
ناوه فره,0504052153,49,181,86,95,4,0504
قورچي باشي,0504351895,39,154,79,75,4,0504
خزانه دول,0504052110,0,0,0,0,4,0504
دستک سفلي,0504052111,13,42,18,24,4,0504
دستک عليا,0504052112,51,161,76,85,4,0504
سرابله,0504052118,127,435,219,216,4,0504
کلينه,0504052133,31,108,47,61,4,0504
گلم کبودعليا,0504052142,47,190,95,95,4,0504
گلخاطر,0504052144,0,0,0,0,4,0504
تپه نادري,0504052152,0,0,0,0,4,0504
ورکورک,0504052155,0,0,0,0,4,0504
گلم کبودسفلي,0504352066,20,70,32,38,4,0504
زرين جوب,0504052116,110,379,205,174,4,0504
قراويز,0504052124,134,453,231,222,4,0504
بابااسکندر,0504351893,70,254,137,117,4,0504
شهرک,0504353049,0,0,0,0,4,0504
قره بلاغ اعظم,0504052125,203,803,395,408,4,0504
قره بلاغ شيخ مراد,0504052126,41,155,79,76,4,0504
شهرک زراعي قره بلاغ,0504352067,167,681,336,345,4,0504
سراب گرم سفلي,0504052238,20,72,37,35,4,0504
سراب گرم عليا,0504052239,41,163,89,74,4,0504
شهرک بانگر,0504052240,0,0,0,0,4,0504
عسگرخاني,0504052243,54,183,95,88,4,0504
اب باريک,0504053287,73,246,120,126,4,0504
خاتونه,0504053296,47,170,88,82,4,0504
ريخک سفلي,0504053301,21,58,30,28,4,0504
ريخک عليا,0504053302,9,37,14,23,4,0504
زرين جو,0504053303,22,71,34,37,4,0504
زيلوبسطام,0504053304,12,36,17,19,4,0504
ميان ميل,0504053322,35,99,42,57,4,0504
هنيدر تعويض,0504053327,6,24,7,17,4,0504
هنيدرمفروضه,0504053328,42,137,78,59,4,0504
پس پس,0504052101,64,238,117,121,4,0504
تپه رش کلاشي,0504052105,157,594,315,279,4,0504
رشيدعباس,0504052115,58,186,91,95,4,0504
قلعه رشيداقا,0504052130,62,203,102,101,4,0504
بريموند,0504052097,77,261,136,125,4,0504
دماغ سفيد,0504052113,31,107,56,51,4,0504
دول الياس,0504052114,39,125,64,61,4,0504
ظله رش,0504052123,15,39,20,19,4,0504
اب باريک سفلي,0505052331,14,55,27,28,4,0505
ارانله,0505052334,55,166,79,87,4,0505
چوگان,0505052359,73,257,132,125,4,0505
حسين ابادده بنه,0505052361,37,126,63,63,4,0505
خاتم اباد,0505052364,50,165,86,79,4,0505
دارحيدر,0505052367,26,90,37,53,4,0505
شريف اباد,0505052378,15,59,26,33,4,0505
علي بلاغ,0505052384,13,37,18,19,4,0505
نوراباد,0505052406,24,85,36,49,4,0505
تازه ابادکرسوان,0505052346,56,175,83,92,4,0505
چاقر,0505052352,0,0,0,0,4,0505
چشمه قره,0505052357,19,73,37,36,4,0505
ده خزل,0505052371,17,55,26,29,4,0505
عرب اباد,0505052385,5,13,7,6,4,0505
کرسوان,0505052392,25,73,36,37,4,0505
ده کهنه,0505052405,0,0,0,0,4,0505
هزارخاني سفلي,0505052408,82,299,142,157,4,0505
هزارخاني عليا,0505052409,129,428,219,209,4,0505
مزرعه داربيد,0505351939,0,0,0,0,4,0505
ميخواران پيرعليخان,0505052342,47,208,96,112,4,0505
چرمله عليا,0505052355,98,361,183,178,4,0505
دره وزم,0505052368,12,46,19,27,4,0505
ميخواران سادات,0505052381,0,0,0,0,4,0505
خسروابادفعله گري,0505052391,40,133,68,65,4,0505
ميخواران محمداقا,0505052399,58,207,103,104,4,0505
مزرعه دره باغ,0505052404,0,0,0,0,4,0505
ورمقان,0505052407,46,170,78,92,4,0505
چرمله سفلي,0505052354,201,656,325,331,4,0505
يوسف جرد,0505052411,139,422,200,222,4,0505
منصورعرب,0505052338,55,153,73,80,4,0505
حاجي اباد,0505052360,33,111,53,58,4,0505
خانجمال زماني,0505052366,55,170,79,91,4,0505
ميخواران محمدصادق,0505052373,58,188,91,97,4,0505
خلجان,0505052335,17,61,30,31,4,0505
خانجمال پناهي,0505052365,48,177,90,87,4,0505
کلگاه زمان,0505052393,241,809,401,408,4,0505
جوب آسياب,0505052402,0,0,0,0,4,0505
باقله عليا,0505048697,27,88,38,50,4,0505
پيرمحمد,0505048710,16,52,21,31,4,0505
چشمه باد,0505048717,19,57,31,26,4,0505
چشمه زنگي,0505048719,29,118,61,57,4,0505
چنگيزه,0505048721,53,154,72,82,4,0505
سه قولان,0505048758,7,19,12,7,4,0505
کاهل اباد,0505048781,13,40,20,20,4,0505
کشکمير,0505048782,21,63,31,32,4,0505
سرکشکمير,0505048783,22,82,42,40,4,0505
کيونان,0505048793,82,238,125,113,4,0505
مزرعه تازه اباد,0505352994,0,0,0,0,4,0505
اکبراباد,0505048694,57,177,95,82,4,0505
باقر اباد,0505048698,26,80,42,38,4,0505
پشت دربند,0505048705,19,57,29,28,4,0505
پنبه دول,0505048707,0,0,0,0,4,0505
خانقاه سفلي,0505048726,38,103,53,50,4,0505
خانقاه عليا,0505048727,32,109,60,49,4,0505
خانقاه وسطي,0505048728,35,114,57,57,4,0505
قشلاق سرداراشرف,0505048766,21,68,36,32,4,0505
مزرعه کاني باباپير,0505048779,0,0,0,0,4,0505
کهريز حاج خانمراد,0505048792,21,72,36,36,4,0505
لنجاب,0505048799,43,327,75,252,4,0505
اگاه سفلي,0505048695,25,84,44,40,4,0505
باقله سفلي,0505048696,26,80,43,37,4,0505
تپه اسماعيل,0505048711,36,108,55,53,4,0505
چشمه خسرو,0505048718,25,90,46,44,4,0505
سامله,0505048746,66,225,111,114,4,0505
سرخم,0505048750,23,68,40,28,4,0505
قول دره,0505048764,33,113,61,52,4,0505
ورج,0505048810,10,32,15,17,4,0505
ويژه,0505048815,31,99,46,53,4,0505
سمن بان,0505048754,62,213,100,113,4,0505
امين فتاح بگ,0506052824,42,124,61,63,4,0506
داربلوط,0506052830,31,103,56,47,4,0506
شيرين اب,0506052832,69,224,105,119,4,0506
طهماسب,0506052833,35,114,62,52,4,0506
نصرابادپاشا,0506052940,22,89,48,41,4,0506
نصراباد سيدحاتم,0506052942,56,200,102,98,4,0506
برفي کوشکري,0506351958,59,226,122,104,4,0506
تازه ابادشيرعلي,0506353075,16,50,28,22,4,0506
کارخانه اسفالت شهرداري قصرشيرين,0506353173,0,0,0,0,4,0506
کلانتر,0506052823,31,84,39,45,4,0506
سيداياز,0506052831,130,406,211,195,4,0506
اقابرار,0506052893,103,313,151,162,4,0506
نصرابادسيداحمد,0506052941,86,273,138,135,4,0506
باباهادي,0506052892,0,0,0,0,4,0506
حسين اباد,0506052894,0,0,0,0,4,0506
دارخور,0506052895,0,0,0,0,4,0506
شکر احمد آباد,0506052896,0,0,0,0,4,0506
اغ داغ شهسوار,0506052897,0,0,0,0,4,0506
هدايت,0506052898,0,0,0,0,4,0506
قلعه سفيد,0506052899,0,0,0,0,4,0506
کوره هاي گچ پزي قصرشيرين,0506052901,0,0,0,0,4,0506
گمرککهنه,0506052902,0,0,0,0,4,0506
نصراباد سيدخليل,0506052943,87,263,123,140,4,0506
برارعزيز,0506352072,0,0,0,0,4,0506
پاسگاه انتظامي اقابرار,0506353114,0,0,0,0,4,0506
کارخانه آجرماشيني آق داغ غرب,0506353115,0,0,0,0,4,0506
شرکت تعاوني شماره 408پرواربندي گوسال,0506353116,0,0,0,0,4,0506
پاسگاه نيروي انتظامي پرويزخان,0506353117,0,0,0,0,4,0506
شرکت تعاوني 2296 آرمين گستر محصولات گلخانه اي,0506353174,0,0,0,0,4,0506
عباس اباد,0507053024,104,364,171,193,4,0507
قوره جيل,0507053042,38,122,58,64,4,0507
رستم ابادکوچک,0507351427,141,463,231,232,4,0507
اکبراباد,0507052989,54,167,74,93,4,0507
سريوه,0507053018,0,0,0,0,4,0507
کندکيله,0507053050,27,89,48,41,4,0507
چم گاوميش,0507053061,0,0,0,0,4,0507
محمداباد,0507351335,59,190,96,94,4,0507
حمزه اباد,0507351341,30,96,46,50,4,0507
نهرالدوله,0507352055,43,138,64,74,4,0507
کرماجان,0507053048,185,584,290,294,4,0507
سلطان اباد,0507053019,190,633,304,329,4,0507
فيروزابادتپه,0507053032,96,339,159,180,4,0507
فيروزابادکوچک,0507053033,33,120,55,65,4,0507
مزرعه قلعه فولاد,0507053064,0,0,0,0,4,0507
خليل اباد,0507053006,57,205,99,106,4,0507
کريم اباد,0507352052,23,86,45,41,4,0507
باني ميران,0509050795,31,129,64,65,4,0509
ده رش بازان,0509050799,6,22,13,9,4,0509
تازه اباد لاباغ,0509050812,15,50,30,20,4,0509
تازه ابادميرکي,0509050814,26,109,51,58,4,0509
چشمه زيلان,0509050829,75,270,134,136,4,0509
چوگل اباد,0509050837,15,59,28,31,4,0509
خيل فاتکي کن,0509050854,20,81,43,38,4,0509
خيل نقده,0509050855,0,0,0,0,4,0509
ده خليفه,0509050869,0,0,0,0,4,0509
زلاني,0509050878,0,0,0,0,4,0509
سورواش اعظم,0509050890,4,16,7,9,4,0509
سورواش اعظم سفلي,0509050891,0,0,0,0,4,0509
سول آباد,0509050892,0,0,0,0,4,0509
فولادي سفلي,0509050909,45,177,88,89,4,0509
فولادي عليا,0509050910,25,98,44,54,4,0509
حشارگه برگور,0509050915,7,27,11,16,4,0509
کاني سواران,0509050921,0,0,0,0,4,0509
مزرعه برده رش عليا,0509050945,9,44,17,27,4,0509
باني گمکان / کاني سواران /,0509050794,15,51,25,26,4,0509
باني گلان,0509050804,22,79,36,43,4,0509
تازه اباد باني عزيز,0509050811,14,51,28,23,4,0509
چشمه بلورک,0509050831,21,71,35,36,4,0509
نهراب ده رش,0509050871,47,183,96,87,4,0509
سياران نهراب,0509050894,40,166,83,83,4,0509
علي آقايي,0509050907,7,28,12,16,4,0509
سرابس,0509050884,150,539,279,260,4,0509
چمن زارسفلي,0509050832,54,178,82,96,4,0509
چمن زاروسطي,0509050834,0,0,0,0,4,0509
سراب برده زنجيرعليا,0509050883,82,299,127,172,4,0509
گناني,0509050932,20,63,26,37,4,0509
سراب برده زنجيرسفلي,0509050981,31,116,52,64,4,0509
چمن زار عليا,0509352965,50,170,77,93,4,0509
اميراباد,0510048175,5,16,8,8,4,0510
تازه اباد,0510048184,32,94,44,50,4,0510
چشمه الوچه,0510048192,67,229,102,127,4,0510
خليل اله,0510048202,8,26,12,14,4,0510
سرچمن,0510048209,0,0,0,0,4,0510
سياه خاني,0510048212,39,123,61,62,4,0510
قروجنگ,0510048223,10,38,19,19,4,0510
کرتويج عليا,0510048229,89,288,134,154,4,0510
گرماب,0510048237,22,80,41,39,4,0510
ملحانه,0510048246,14,43,16,27,4,0510
کري زاغه,0510048961,43,182,90,92,4,0510
پايگاه جنگلباني,0510351779,0,0,0,0,4,0510
اسلام اباد بزه رود,0510048174,13,38,18,20,4,0510
ترازوبره,0510048186,53,157,79,78,4,0510
چشمه غلام ويس,0510048194,62,189,100,89,4,0510
حجت اباد,0510048198,96,316,161,155,4,0510
قلعه بزه رود,0510048225,58,161,81,80,4,0510
پريان,0510048182,36,112,60,52,4,0510
شريف اباد,0510048216,51,145,72,73,4,0510
مزرعه عثمان دره,0510048244,0,0,0,0,4,0510
امام زاده پيريافته,0510351778,0,0,0,0,4,0510
ازناب سفلي,0510048172,9,29,12,17,4,0510
ازناب عليا,0510048173,15,53,29,24,4,0510
چشمه بيگلر,0510048193,15,49,21,28,4,0510
چشمه قنبر,0510048195,28,85,42,43,4,0510
علي اباد,0510048222,38,129,66,63,4,0510
کرتويج سفلي,0510048228,47,155,75,80,4,0510
کنگ,0510048235,117,388,174,214,4,0510
کهريز,0510048236,27,80,38,42,4,0510
دره مران,0510048337,0,0,0,0,4,0510
سراب,0510048339,66,201,104,97,4,0510
قشلاق حمامدره,0510048342,48,147,69,78,4,0510
لولان,0510048347,0,0,0,0,4,0510
راهدارخانه,0510805021,0,0,0,0,4,0510
مزرعه دره نظر,0510047916,0,0,0,0,4,0510
درويشان,0510048336,67,205,101,104,4,0510
دهمرادخان,0510048338,199,602,306,296,4,0510
علي اباد,0510048341,0,0,0,0,4,0510
قشلاق کليددره,0510048343,45,156,76,80,4,0510
چم سرخ,0510047903,16,55,26,29,4,0510
چنار شوه,0510047912,0,0,0,0,4,0510
عامله,0510047942,75,230,103,127,4,0510
علي ابادگروس,0510047946,27,80,40,40,4,0510
گروس سفلي,0510047975,32,111,55,56,4,0510
گروس عليا,0510047976,23,88,42,46,4,0510
درکه,0510048335,301,956,453,503,4,0510
سراسياب,0510047922,53,162,86,76,4,0510
سياه چقا,0510047932,194,622,300,322,4,0510
عين القاص,0510047950,59,183,91,92,4,0510
تپان,0512050816,67,270,136,134,4,0512
حلول,0512050845,102,430,234,196,4,0512
زمکان عليا,0512050879,109,414,213,201,4,0512
مزرعه دشتي له,0512050950,0,0,0,0,4,0512
مزرعه ولين,0512050959,0,0,0,0,4,0512
نيرژسفلي,0512050972,48,209,113,96,4,0512
نيرژعليا,0512050973,35,138,65,73,4,0512
حوض شيخ زمکان,0512050846,16,67,33,34,4,0512
شاه گدارزمکان,0512050896,14,54,26,28,4,0512
مله اواره,0512050961,10,48,25,23,4,0512
ميراباد,0512050969,260,966,459,507,4,0512
تپه خرگوشان,0512050817,48,210,99,111,4,0512
تپه کبود,0512050818,16,56,31,25,4,0512
عبداله خاکي عليا,0512050904,19,69,32,37,4,0512
عبداله خاکي سفلي,0512050905,21,87,41,46,4,0512
عزيزابادبناوج,0512050906,27,135,62,73,4,0512
قاپ قلي,0512050911,43,152,69,83,4,0512
کچل اباد,0512050923,11,55,25,30,4,0512
نيمه کاره,0512050975,68,279,132,147,4,0512
آلوينه گر,0512050787,0,0,0,0,4,0512
دواله برگله,0512050801,0,0,0,0,4,0512
پشت گله ماده زاران,0512050806,15,54,27,27,4,0512
چم رود,0512050828,17,61,23,38,4,0512
حشمر,0512050844,83,318,158,160,4,0512
خمگران,0512050852,29,108,59,49,4,0512
دنگي,0512050864,25,94,49,45,4,0512
دواله بان ميري,0512050867,32,114,59,55,4,0512
دواله پايين,0512050868,13,48,25,23,4,0512
لاسوار,0512050889,14,51,22,29,4,0512
تمر خان,0512050908,38,140,72,68,4,0512
کالوين,0512050916,4,12,4,8,4,0512
کزه,0512050926,18,60,28,32,4,0512
مله توت,0512050962,0,0,0,0,4,0512
ويله مله رش,0512050963,5,15,6,9,4,0512
ورگرساروند,0512050977,0,0,0,0,4,0512
سکوي تله توت,0512352930,0,0,0,0,4,0512
مزرعه کزي,0512352964,0,0,0,0,4,0512
مله کبود,0512353099,16,64,35,29,4,0512
دشتي ليل حسين اباد,0512050862,45,160,86,74,4,0512
بناوچ,0512050897,30,120,71,49,4,0512
ايستگاه تقويت تلويزيون,0513046738,0,0,0,0,4,0513
ايستگاه مخابرات سرخه ديزه,0513046739,0,0,0,0,4,0513
پاسگاه نيروي انتظامي بالاطاق,0513046741,0,0,0,0,4,0513
پمپاژنفت,0513046743,0,0,0,0,4,0513
سرخه ديزه,0513046751,47,146,80,66,4,0513
سرميل,0513046752,29,109,54,55,4,0513
شيره چقا,0513046755,26,88,46,42,4,0513
جسر,0513046762,0,0,0,0,4,0513
مزرعه کوکاب,0513046765,0,0,0,0,4,0513
ميان تنگ,0513046768,11,32,17,15,4,0513
ورگنبد,0513046769,10,39,17,22,4,0513
هلته,0513046770,36,104,52,52,4,0513
آواره هاي بلوان,0513351684,0,0,0,0,4,0513
شهرک هلته,0513351761,92,279,139,140,4,0513
ايستگاه مخابراتي کرند,0513046740,0,0,0,0,4,0513
حرير,0513046746,193,713,351,362,4,0513
حصيل قنبره,0513046747,0,0,0,0,4,0513
سرچقا,0513046750,76,280,142,138,4,0513
مزرعه کپنگ سفيد,0513046766,0,0,0,0,4,0513
مزرعه ميشله,0513046767,0,0,0,0,4,0513
چقاکوچکينه,0513046745,0,0,0,0,4,0513
سليمان اباد,0513046753,55,184,97,87,4,0513
طلسم,0513046756,53,188,84,104,4,0513
گاودانه خور,0513046760,99,391,211,180,4,0513
مزرعه چهل گزي,0513046763,0,0,0,0,4,0513
زرد اباد,0513046764,0,0,0,0,4,0513
هوکاني سفلي,0513046771,9,30,13,17,4,0513
هوکاني عليا,0513046772,25,86,44,42,4,0513
علي آباد بابا جاني,0513351762,0,0,0,0,4,0513
پشت تنگ اسماعيل بيگ,0513046742,0,0,0,0,4,0513
چشمه سفيد,0513046744,108,374,182,192,4,0513
گاوسور,0513046761,196,768,363,405,4,0513
خسرواباد,0513046748,103,409,209,200,4,0513
بناوچکو,0514050803,35,128,67,61,4,0514
پشت تنگ چشمه قلي جان,0514050805,37,123,61,62,4,0514
تازه ابادمله ترشي,0514050813,4,18,7,11,4,0514
پشت تنگ شاينگان,0514050820,9,36,17,19,4,0514
چراغستان,0514050830,5,23,12,11,4,0514
ده سرخ,0514050872,29,118,63,55,4,0514
شان رش حاجي آباد,0514050895,30,88,44,44,4,0514
شاينگان,0514050898,48,165,78,87,4,0514
شش بيدسفلي,0514050899,13,45,24,21,4,0514
شش بيدعليا,0514050900,35,120,46,74,4,0514
کاني پاشا,0514050918,25,91,46,45,4,0514
کزازي,0514050925,9,35,17,18,4,0514
چناران  /کناگرگ/,0514050931,35,143,64,79,4,0514
کيلانبر عليا,0514050937,0,0,0,0,4,0514
حسن ابادکره,0514050841,54,180,93,87,4,0514
درگه,0514050856,18,53,25,28,4,0514
رييس,0514050877,34,109,50,59,4,0514
کره قلعه کهنه,0514050913,30,96,44,52,4,0514
کره قلعه سفيد,0514050924,28,103,47,56,4,0514
کيلانبر سفلي,0514050936,10,39,19,20,4,0514
ماخوشين,0514050942,68,234,122,112,4,0514
چشمه سفيدشبانکاره,0514051632,35,108,54,54,4,0514
مزرعه بانچيا سفلي,0514051618,7,24,10,14,4,0514
خانيله,0514051636,0,0,0,0,4,0514
دولتاباد,0514051641,103,326,161,165,4,0514
سراب گرم گراب,0514051647,18,61,24,37,4,0514
سرابيان,0514051648,28,111,51,60,4,0514
فيروزه,0514051655,84,287,135,152,4,0514
گراب عليا,0514051666,40,137,64,73,4,0514
گمشترسفلي,0514051669,0,0,0,0,4,0514
مامنان سفلي,0514051673,45,141,74,67,4,0514
مامنان عليا,0514051674,41,146,74,72,4,0514
مزرعه بانگلان,0514051676,0,0,0,0,4,0514
مزرعه بانچياعليا,0514051677,0,0,0,0,4,0514
خپگه,0501047558,142,472,232,240,4,0501
سراب شوهان,0501047560,45,149,73,76,4,0501
شوهان عليا,0501047563,11,37,16,21,4,0501
شوهان سفلي,0501350093,44,144,75,69,4,0501
توه سرخک سفلي,0501047704,174,611,324,287,4,0501
توه سرخک عليا,0501047705,39,141,73,68,4,0501
توه سرخک نسار,0501047706,35,132,64,68,4,0501
مله سرخ,0501047733,71,251,122,129,4,0501
پلنگرد,0501047555,160,530,262,268,4,0501
توميانه,0501047556,62,196,102,94,4,0501
سراب ميله سر,0501047561,86,326,155,171,4,0501
ظهراب,0501047565,0,0,0,0,4,0501
مزرعه توه سرخک سيدي,0501047728,0,0,0,0,4,0501
تازه آبادبدرگرد,0501047146,46,190,98,92,4,0501
قوچمي,0501047566,86,325,157,168,4,0501
ميله سر,0501047574,182,614,308,306,4,0501
چقاجنگه سفلي,0501047120,44,151,76,75,4,0501
چقاجنگه عليا,0501047121,78,270,137,133,4,0501
گردنگاه قوچمي,0501047154,182,686,353,333,4,0501
بدره گردسليمي,0501351764,17,57,34,23,4,0501
اشرف اباد,0502049218,0,0,0,0,4,0502
چوبدراز,0502049239,80,371,183,188,4,0502
شادمان,0502049268,39,146,66,80,4,0502
شورابه,0502049271,0,0,0,0,4,0502
عمه,0502049278,67,268,122,146,4,0502
کنجورعليا,0502049294,33,115,52,63,4,0502
باقله,0502049224,41,154,72,82,4,0502
بالاگبري,0502049225,19,59,27,32,4,0502
پشته کش,0502049232,106,368,177,191,4,0502
سنگسفيد,0502049263,20,63,27,36,4,0502
سيابان,0502049265,39,139,63,76,4,0502
شلان,0502049270,26,83,37,46,4,0502
کبوده سفلي,0502049286,23,81,42,39,4,0502
کبوده عليا,0502049287,23,83,36,47,4,0502
گوشبران,0502049305,35,134,68,66,4,0502
مزرعه سراب قنبر,0502353032,0,0,0,0,4,0502
بريموند,0502049226,86,318,148,170,4,0502
حسين اباد,0502049242,0,0,0,0,4,0502
زنگيشه,0502049251,42,160,77,83,4,0502
کهرارسفلي,0502049296,93,361,166,195,4,0502
کهرارعليا,0502049297,67,267,126,141,4,0502
کهرارموقوفه,0502049298,40,153,77,76,4,0502
گاوشان عليا,0502049303,41,147,66,81,4,0502
هولان,0502049319,36,136,74,62,4,0502
بلين,0502049229,15,66,34,32,4,0502
دشتله سفلي,0502049246,25,97,46,51,4,0502
دشتله عليا,0502049247,20,74,40,34,4,0502
زنگي وند,0502049253,19,97,47,50,4,0502
سردشتله,0502049257,8,24,10,14,4,0502
سردوکانه,0502049258,15,72,34,38,4,0502
سنبل تازه اباد,0502049260,0,0,0,0,4,0502
سنبل سفلي,0502049261,0,0,0,0,4,0502
سيل گبري,0502049266,0,0,0,0,4,0502
کمراب,0502049292,47,183,93,90,4,0502
کهرار دجگه,0502049295,31,107,54,53,4,0502
ماواي سفلي,0502049306,35,157,75,82,4,0502
ماواي عليا,0502049307,14,55,23,32,4,0502
نيروند,0502049315,10,38,19,19,4,0502
وروا,0502049317,29,131,65,66,4,0502
هفتچشمه,0502049318,8,32,15,17,4,0502
مزرعه سنبله,0502351827,0,0,0,0,4,0502
انگز,0502049219,29,117,57,60,4,0502
انگزبان,0502049220,7,27,17,10,4,0502
جامه شوران سفلي,0502049237,39,185,101,84,4,0502
جامه شوران عليا,0502049238,10,36,17,19,4,0502
حاجي عليان,0502049241,54,230,117,113,4,0502
دوکانه,0502049248,28,119,54,65,4,0502
سرجامه شوران,0502049256,9,42,19,23,4,0502
شيرازي بوري,0502049272,0,0,0,0,4,0502
شيرازي سفلي,0502049273,12,63,35,28,4,0502
شيرازي عليا,0502049274,8,38,19,19,4,0502
شيرازي ميرزابگ,0502049275,0,0,0,0,4,0502
شيرازي وسطي,0502049276,0,0,0,0,4,0502
کله هو,0502049291,69,323,149,174,4,0502
تيشه کن,0502049236,85,338,165,173,4,0502
قورباغستان سفلي,0502049282,90,342,141,201,4,0502
قورباغستان عليا,0502049283,37,166,79,87,4,0502
کنجورسفلي,0502049293,80,296,140,156,4,0502
گاوشان سفلي,0502049302,33,135,65,70,4,0502
بي بيان,0504052100,61,227,118,109,4,0504
قلخانچک شاه طوطيا,0504052127,23,91,44,47,4,0504
کلاشي عبدالقادر,0504052134,50,220,102,118,4,0504
مله ديزگه,0504052148,22,83,41,42,4,0504
برق باراني سفلي,0504052095,21,85,41,44,4,0504
برق باراني عليا,0504052096,4,12,5,7,4,0504
تپه ماران,0504052106,115,518,261,257,4,0504
صالح کوچري,0504052121,14,55,31,24,4,0504
طايشه محمود نظري,0504052122,98,392,207,185,4,0504
قلعه ذهاب,0504052129,73,264,133,131,4,0504
بيشگان,0504351899,14,51,22,29,4,0504
الياس محمود,0504052092,40,159,70,89,4,0504
الياسي خليفه حسين,0504052093,36,157,73,84,4,0504
تپاني,0504052103,129,548,258,290,4,0504
سراب ذهاب,0504052117,73,336,171,165,4,0504
اکبراباد,0504052090,0,0,0,0,4,0504
اکبرابادالياسي,0504052091,0,0,0,0,4,0504
تپه داراب خان,0504052104,32,144,68,76,4,0504
تنگ حمام,0504052107,0,0,0,0,4,0504
جابري,0504052109,34,136,67,69,4,0504
قلعه بهادري,0504052128,129,527,259,268,4,0504
قلعه واري,0504052131,54,209,89,120,4,0504
کلاره ژاله,0504052135,17,76,38,38,4,0504
کلاره مهرابي,0504052137,7,36,17,19,4,0504
مجري لان,0504052146,16,66,28,38,4,0504
ميرميرو,0504052151,21,72,41,31,4,0504
نوشيروان,0504052154,35,124,66,58,4,0504
کلاره سه تپان,0504351896,0,0,0,0,4,0504
گراهنگران,0504351897,0,0,0,0,4,0504
ماسه شويي شهرداري,0504353052,0,0,0,0,4,0504
ماسه شويي تعاوني شماره 879,0504353160,0,0,0,0,4,0504
کوييک حسن,0504052138,152,598,302,296,4,0504
کوييک عزيزي,0504052139,195,701,367,334,4,0504
کوشکري نامدار,0504052145,30,110,63,47,4,0504
کوييک مجيد,0504052140,61,233,110,123,4,0504
کوييک محمود,0504052141,56,222,119,103,4,0504
ايينله,0505052598,55,163,75,88,4,0505
بلوطستان,0505052599,7,23,9,14,4,0505
گلويج,0505052605,45,119,63,56,4,0505
خياران,0505052606,78,269,128,141,4,0505
پير سليمان,0505052607,23,62,30,32,4,0505
سردره بيگلربيگي,0505052608,32,103,48,55,4,0505
دروازه,0505052609,0,0,0,0,4,0505
جاميشان عليا,0505052610,56,177,81,96,4,0505
نجف اباد,0505052611,41,143,69,74,4,0505
تازه ابادسراب,0505052345,25,85,36,49,4,0505
حسين اباد قوري چاي,0505052362,23,76,35,41,4,0505
شمسک,0505052379,20,64,33,31,4,0505
قوري چاي,0505052390,46,157,77,80,4,0505
صفاييه,0505052565,83,281,147,134,4,0505
غيب اله,0505052602,27,91,42,49,4,0505
عباس اباد,0505052603,44,143,61,82,4,0505
زنگنه,0505052604,45,141,68,73,4,0505
خنجراباد,0505052540,28,108,55,53,4,0505
نخودتپه,0505052595,57,252,91,161,4,0505
قروه,0505052600,45,134,66,68,4,0505
گزنهله,0505052601,176,527,257,270,4,0505
کارخانه اسفالت شهرداري سنقر,0505052574,0,0,0,0,4,0505
غياث اباد,0505052612,33,108,54,54,4,0505
سلطان اباد,0505351943,0,0,0,0,4,0505
آقبلاغ,0505052337,197,623,334,289,4,0505
ليلمانج,0505052398,191,603,292,311,4,0505
خميس اباد,0507053007,156,504,254,250,4,0507
علي اباداول,0507053028,65,232,108,124,4,0507
علي اباددوم,0507053029,40,141,63,78,4,0507
اسلام اباد,0507053035,67,217,102,115,4,0507
شورچه,0507053022,182,604,296,308,4,0507
حسين اباد,0507053001,110,399,201,198,4,0507
ده بالا,0507053009,0,0,0,0,4,0507
کوچه,0507053051,163,544,255,289,4,0507
اردوگاه حلبچه,0507351966,0,0,0,0,4,0507
اله دانه,0507052990,0,0,0,0,4,0507
چشمه نوش,0507052997,54,180,96,84,4,0507
حاجي اباد,0507052998,15,53,29,24,4,0507
عزيزاباد,0507053026,14,52,23,29,4,0507
گلبداغ,0507053054,0,0,0,0,4,0507
گلياران,0507053055,0,0,0,0,4,0507
سهم الدين,0507351398,0,0,0,0,4,0507
مزرعه مراداباد,0507351961,0,0,0,0,4,0507
علي اباد,0507351965,42,155,85,70,4,0507
مزرعه حاج محمدباقرطاهرابادي,0507351970,0,0,0,0,4,0507
دامداري حاج عباس رضايي,0507351982,0,0,0,0,4,0507
اشرف آباد,0507805018,5,16,9,7,4,0507
طاهراباد,0507053023,241,818,392,426,4,0507
قاسم اباد,0507053037,0,0,0,0,4,0507
رحمت اباد,0507053012,155,506,258,248,4,0507
رستم ابادبزرگ,0507053013,97,308,152,156,4,0507
انجاورود,0508053290,59,222,105,117,4,0508
تنگ لانه بان صفر,0508053292,0,0,0,0,4,0508
چمن,0508053295,17,53,26,27,4,0508
مزرعه بن طاوي,0508053316,0,0,0,0,4,0508
مزرعه شبانکاره,0508053318,0,0,0,0,4,0508
مزرعه نسارگلين,0508053326,0,0,0,0,4,0508
گلين اله مراد,0508351741,25,80,39,41,4,0508
امامقلي,0508053289,14,56,23,33,4,0508
جوبباغان عليا,0508053294,38,110,63,47,4,0508
شاهمار,0508053308,50,178,89,89,4,0508
چوب باغان,0508053311,140,434,234,200,4,0508
مزرعه خانجان,0508053317,0,0,0,0,4,0508
شلين,0508351740,72,225,117,108,4,0508
جوبباغان سفلي,0508053293,29,114,61,53,4,0508
دارابي,0508053297,33,97,51,46,4,0508
ميان رود,0508053321,24,93,47,46,4,0508
نسارديره,0508053324,219,729,384,345,4,0508
گلوزي داود,0508351560,5,16,7,9,4,0508
افشاراباد,0508053288,7,25,11,14,4,0508
بطياراحمد,0508053291,0,0,0,0,4,0508
دارون 1,0508053298,7,23,10,13,4,0508
دارون 2,0508053299,21,76,40,36,4,0508
دارون 3,0508053300,24,95,47,48,4,0508
سنگ درميان سفلي,0508053306,28,84,43,41,4,0508
سنگ درميان عليا,0508053307,32,117,60,57,4,0508
شنقال خالدي,0508053310,69,284,138,146,4,0508
شيشه راه,0508053312,33,127,67,60,4,0508
گلوزي,0508053314,97,308,152,156,4,0508
نسارديره سفلي,0508053325,6,21,11,10,4,0508
عليجان,0508351704,6,21,7,14,4,0508
چرخاب,0510047904,44,142,63,79,4,0510
چشمه حيدر,0510047905,0,0,0,0,4,0510
عمارت,0510047949,22,67,31,36,4,0510
لرخاني,0510047978,24,90,41,49,4,0510
ارگنه سفلي,0510047875,167,514,251,263,4,0510
ارگنه عليا,0510047876,83,275,141,134,4,0510
گاودانه گدار,0510047971,67,193,96,97,4,0510
مزرعه اسداباد,0510047878,0,0,0,0,4,0510
چشمه قادر,0510047907,22,63,29,34,4,0510
گاوکل قلعه,0510047972,57,190,90,100,4,0510
گاوکل عليا,0510047973,99,359,192,167,4,0510
محمود اباد,0510047986,94,301,155,146,4,0510
ايلخاني اباد,0510047880,81,274,138,136,4,0510
بابان اباد,0510047881,30,116,62,54,4,0510
سرخه ميري,0510047923,71,223,115,108,4,0510
مال اميري عليا,0510047981,67,191,95,96,4,0510
يک جفتي,0510047997,30,95,41,54,4,0510
تخت شيرين,0510047896,58,200,95,105,4,0510
چقاجانعلي,0510047910,130,459,234,225,4,0510
مال اميري سفلي,0510047980,98,336,167,169,4,0510
يکدانگي,0510047998,63,206,103,103,4,0510
علي گرزان سفلي,0510047947,116,375,185,190,4,0510
پيروزه,0514047246,9,24,14,10,4,0514
جان جان,0514047286,29,90,47,43,4,0514
روتوند,0514047290,18,53,24,29,4,0514
سبزبلاغ,0514047295,39,134,60,74,4,0514
شله,0514047302,57,181,85,96,4,0514
قلعه خدا مروت خان,0514047314,31,105,50,55,4,0514
قلعه فرج الله بيگ,0514047317,8,25,10,15,4,0514
کچکينه,0514047324,17,59,36,23,4,0514
کندوله,0514047328,48,170,88,82,4,0514
نوروله سفلي,0514047365,8,27,12,15,4,0514
نوروله عليا,0514047366,58,224,127,97,4,0514
نهرابي,0514051694,123,395,186,209,4,0514
ده چراغ,0514047287,37,144,70,74,4,0514
زالواب,0514047291,202,659,336,323,4,0514
کلاوه حيدر خان,0514047327,45,154,77,77,4,0514
گمشترعليا,0514051670,35,130,65,65,4,0514
مزرعه کاني باغ,0514051688,0,0,0,0,4,0514
الياسي,0514047234,14,40,18,22,4,0514
باکلاني,0514047240,38,129,63,66,4,0514
تپه کل,0514047253,107,318,158,160,4,0514
جبر اباد,0514047256,26,93,47,46,4,0514
چقاشکر,0514047262,31,108,52,56,4,0514
خيبر,0514047276,39,123,55,68,4,0514
ده ميراحمد,0514047288,33,112,50,62,4,0514
مزرعه سياه سياه جميل پناه,0514047298,0,0,0,0,4,0514
کردوند,0514047325,0,0,0,0,4,0514
کلمت آباد,0514047337,5,18,12,6,4,0514
لميني,0514047343,28,106,51,55,4,0514
لاچين,0514047344,5,17,8,9,4,0514
ملکشاه,0514047355,11,40,17,23,4,0514
ولي اباد,0514350042,7,25,10,15,4,0514
سياه سياه,0514351771,0,0,0,0,4,0514
باغ وزمان,0507052993,0,0,0,0,4,0507
بردينه سيدها,0507052994,0,0,0,0,4,0507
توشمالان,0507052995,48,161,80,81,4,0507
جاورسينه,0507052996,0,0,0,0,4,0507
حاجي آباد,0507052999,11,29,13,16,4,0507
خارکش,0507053004,0,0,0,0,4,0507
ده نو,0507053010,30,81,45,36,4,0507
سرمست,0507053016,21,67,35,32,4,0507
سرمه کوکان,0507053017,0,0,0,0,4,0507
قره گوزلوسفلي,0507053038,116,386,192,194,4,0507
قره گوزلوعليا,0507053039,39,120,52,68,4,0507
قزوينه,0507053040,31,88,45,43,4,0507
قشلاق قره گوزلوسفلي,0507053041,0,0,0,0,4,0507
مزرعه کريم اباد,0507053049,0,0,0,0,4,0507
مزرعه آبشاران,0507053060,0,0,0,0,4,0507
قاسم اباد,0507351324,8,28,15,13,4,0507
شاهسون,0510048340,58,190,91,99,4,0510
پست برق منطقه اي غرب 63 کيلوولت صحنه,0510805020,0,0,0,0,4,0510
اهنگران,0510047879,41,127,57,70,4,0510
پاقلعه,0510047894,46,177,88,89,4,0510
سمنگان سفلي,0510047927,50,181,96,85,4,0510
سمنگان عليا,0510047928,148,481,239,242,4,0510
هاشم اباد,0510047995,64,212,105,107,4,0510
چقاگلان,0510047911,28,102,45,57,4,0510
سرداراباد,0510047924,84,326,162,164,4,0510
شريفاباد,0510047933,69,247,111,136,4,0510
شيخي آباد عليا,0510047939,45,175,81,94,4,0510
محمودابادزرداب,0510047984,91,329,161,168,4,0510
شهرک صنعتي بيستون,0510353176,0,0,0,0,4,0510
دولتاباد,0510047917,64,239,118,121,4,0510
ميرعزيزي,0510048349,78,292,137,155,4,0510
اب باريک شمالي,0510047874,116,412,216,196,4,0510
سنگچين,0510047930,45,152,74,78,4,0510
عباس اباد,0510047943,69,222,108,114,4,0510
قشلاق,0510047953,0,0,0,0,4,0510
کاوس,0510047966,0,0,0,0,4,0510
اب باريک جنوبي,0510351000,99,344,169,175,4,0510
امامزاده عباس,0510352189,5,13,6,7,4,0510
بدربان,0510047884,104,347,160,187,4,0510
حسين اباد,0510047913,23,88,48,40,4,0510
سفيدچقا,0510047925,35,131,65,66,4,0510
شيخي ابادسفلي,0510047938,89,332,158,174,4,0510
قشلاق صيد ناصر,0510047958,30,106,57,49,4,0510
نصرت اباد,0510047994,0,0,0,0,4,0510
کرم پناه آباد,0501047148,99,343,161,182,4,0501
تجردولت اباد,0501047157,8,32,14,18,4,0501
پست برق اسلام آباد,0501047165,0,0,0,0,4,0501
بوربور,0501047522,45,148,73,75,4,0501
تازه ابادطالقان,0501047523,49,177,83,94,4,0501
سراب شيان,0501047525,113,400,201,199,4,0501
کت کتي,0501047529,67,228,117,111,4,0501
ملخطاوي,0501047533,102,336,173,163,4,0501
کمره غربي,0501047568,67,227,107,120,4,0501
ميرعزيزي,0501047534,235,743,382,361,4,0501
قباد,0501047526,128,443,210,233,4,0501
قوخ,0501047528,29,93,47,46,4,0501
معارفي,0501047532,64,226,112,114,4,0501
کمره سفلي,0501047569,126,423,214,209,4,0501
برنجان,0502050067,46,168,90,78,4,0502
ورله,0502050146,51,177,81,96,4,0502
يوان,0502050151,59,191,93,98,4,0502
شهرک ورله,0502353156,55,188,91,97,4,0502
بي ابرچقاماران,0502050070,173,580,275,305,4,0502
پاامام,0502050071,8,25,12,13,4,0502
سراسياب,0502050098,24,82,37,45,4,0502
وزمله,0502050148,20,62,26,36,4,0502
چقاماران,0502350397,86,300,142,158,4,0502
ايستگاه مخابرات خورين,0502050065,0,0,0,0,4,0502
بکتاش اباد,0502050068,58,195,90,105,4,0502
چراغ اباد,0502050080,27,77,43,34,4,0502
ده باغ,0502050092,48,158,72,86,4,0502
ده گل,0502050093,57,187,93,94,4,0502
سرتيپ آباد,0502050099,50,184,92,92,4,0502
سروران,0502050100,26,95,38,57,4,0502
علي اباد,0502050112,56,180,93,87,4,0502
گروران چهاردانگ,0502050128,32,104,50,54,4,0502
گروران دودانگ,0502050129,48,154,71,83,4,0502
جلوگيره سفلي,0502048479,20,67,28,39,4,0502
جلوگيره عليا,0502048480,33,116,50,66,4,0502
خوشينان عليا,0502048492,105,402,198,204,4,0502
دوچقا,0502048502,49,142,68,74,4,0502
سراب شله,0502048511,65,237,110,127,4,0502
کلاه کبودسفلي,0502048533,35,114,51,63,4,0502
کلاه کبودعليا,0502048534,16,49,25,24,4,0502
کلاه کبودوسطي,0502048535,15,49,21,28,4,0502
ملک تپه,0502048559,13,44,18,26,4,0502
هشيلان,0502048570,18,50,20,30,4,0502
اميراباد,0502048458,46,172,81,91,4,0502
بريموند,0502048462,53,187,88,99,4,0502
تپه کبود,0502048468,0,0,0,0,4,0502
جهان اباد,0502048481,28,89,42,47,4,0502
خوشينان سفلي,0502048491,54,178,86,92,4,0502
رستم ابادريکا,0502048506,21,67,32,35,4,0502
سالاراباد,0502048508,12,41,14,27,4,0502
شاهرضا,0502048519,21,71,36,35,4,0502
کمک,0502048536,22,72,33,39,4,0502
ميمون باز,0502048564,14,50,20,30,4,0502
نفته,0502048567,0,0,0,0,4,0502
ياوري,0502048571,25,92,43,49,4,0502
بله کبود,0502050069,19,68,32,36,4,0502
رحمت اباد,0502050095,8,26,13,13,4,0502
شاهرخ اباد,0502050105,17,55,22,33,4,0502
گره چقا,0502050130,42,154,85,69,4,0502
چشمه کبود,0502350453,0,0,0,0,4,0502
امام زاده ويس قرني,0502351847,0,0,0,0,4,0502
مجتمع پرورش مرغ مادر,0502352045,0,0,0,0,4,0502
احمدابادسفلي,0502048455,15,54,23,31,4,0502
احمدابادعليا,0502048456,32,107,47,60,4,0502
تاسوره جان,0502048466,48,153,82,71,4,0502
تپه سبز,0502048467,28,109,51,58,4,0502
تپه لري,0502048469,17,62,28,34,4,0502
خوشينان وسطي,0502048493,41,136,67,69,4,0502
دوتپه,0502048501,26,92,44,48,4,0502
صفي اباد,0502048522,31,102,47,55,4,0502
لعل ابادسفلي,0502048545,0,0,0,0,4,0502
لعل ابادعليا,0502048546,25,89,38,51,4,0502
مصرخان,0502048558,18,67,35,32,4,0502
ميانکوه,0502048563,27,88,43,45,4,0502
اکبراباد,0502050063,36,113,57,56,4,0502
تپه افشار,0502050076,82,293,135,158,4,0502
تکيه,0502050077,86,296,138,158,4,0502
دولت اباد,0502050091,10,32,16,16,4,0502
قاقلستان,0502050116,32,132,72,60,4,0502
گوهرچقا,0502050131,72,264,134,130,4,0502
خانم اباد,0502050086,199,651,323,328,4,0502
گاکيه,0502050123,100,369,178,191,4,0502
محموداباد,0502050133,138,472,232,240,4,0502
اکبرابادخالصه تپه گينو,0502048457,37,145,64,81,4,0502
سورکال,0502050103,37,124,67,57,4,0502
کورسراب,0502050126,9,38,18,20,4,0502
ورمنجه,0502050147,249,819,397,422,4,0502
سرابله,0502050097,38,117,60,57,4,0502
شهرک نظامي سرابله,0502050108,50,164,77,87,4,0502
شيرعلي,0502050110,15,58,28,30,4,0502
خانه خدا,0502050087,26,99,47,52,4,0502
خلک,0502050088,95,387,196,191,4,0502
سياه چقا,0502050104,57,224,111,113,4,0502
تازه ابادعمله,0502050113,70,236,125,111,4,0502
عمله سفلي,0502050114,13,47,22,25,4,0502
عمله عليا,0502050115,66,224,107,117,4,0502
سلطانکوه,0502048515,93,318,156,162,4,0502
باقراباد,0502050066,10,41,22,19,4,0502
پادگان شهيدمنتظري,0502050072,0,0,0,0,4,0502
تبراباد,0502050075,26,87,40,47,4,0502
جعفراباد,0502050079,47,171,82,89,4,0502
چقاماران,0502050081,44,147,67,80,4,0502
حجت اباد,0502050084,18,59,30,29,4,0502
حجت ابادسفلي,0502050085,28,91,47,44,4,0502
کثيراباد,0502050124,6,33,19,14,4,0502
مزرعه پيرويس اباد,0502050137,0,0,0,0,4,0502
ولي اباد,0502050149,11,42,17,25,4,0502
چشمه باغ,0502048952,46,157,71,86,4,0502
توللي,0502050078,72,245,120,125,4,0502
نظام اباد,0502050144,63,224,107,117,4,0502
احمدوند,0502350488,108,415,214,201,4,0502
دوچشمه,0502048954,7,29,17,12,4,0502
سه چشمه,0502048956,45,169,76,93,4,0502
ملاورد,0502048964,11,42,22,20,4,0502
چناره,0502050083,66,254,123,131,4,0502
پادگان نظامي,0502353037,0,0,0,0,4,0502
پيرحياتي,0502049149,80,240,113,127,4,0502
رحيم اباد,0502050096,33,124,59,65,4,0502
دواب,0502050140,0,0,0,0,4,0502
نوروزاباد,0502050145,80,248,122,126,4,0502
شهرک صنعتي,0502350504,59,200,100,100,4,0502
پاوند مکر,0508053608,27,107,48,59,4,0508
مورت شاوله,0508053619,0,0,0,0,4,0508
طايفه سياه سياه,0508053620,14,57,28,29,4,0508
مياندار قروتک,0508053621,17,52,26,26,4,0508
قشقه,0508053622,46,157,91,66,4,0508
مورت سبز,0508053630,32,126,61,65,4,0508
نيان,0508053637,70,239,123,116,4,0508
چم سورک سفلي,0508351551,26,92,45,47,4,0508
چم سورک عليا,0508351552,0,0,0,0,4,0508
چم سورک وسطي,0508351553,24,71,33,38,4,0508
گل خيرک عليا,0508351554,26,91,48,43,4,0508
مورتهادي,0508351555,17,54,30,24,4,0508
گل خيرک سفلي,0508351739,22,72,36,36,4,0508
پشته کبودعلي ميرزا,0508053609,0,0,0,0,4,0508
پنجعلي,0508053610,4,18,13,5,4,0508
داربيدحسين علي,0508053612,0,0,0,0,4,0508
داربيدعلي اکبر,0508053613,7,12,5,7,4,0508
داربيدنظرعلي,0508053614,12,38,17,21,4,0508
سرپلک يوسفي,0508053617,0,0,0,0,4,0508
سرحال شيرزادي,0508053618,52,219,113,106,4,0508
قيلان,0508053623,93,339,183,156,4,0508
مزرعه آهنگران,0508053625,7,29,10,19,4,0508
درويش,0508053626,0,0,0,0,4,0508
سير وله قاسم,0508053627,0,0,0,0,4,0508
مزرعه طارم,0508053628,0,0,0,0,4,0508
گزين,0508053629,0,0,0,0,4,0508
ميان راه,0508053631,11,37,17,20,4,0508
ميرميراب سفلي,0508053633,8,43,23,20,4,0508
ميرميراب عليا,0508053634,62,207,107,100,4,0508
ميه مز,0508053636,0,0,0,0,4,0508
فالوشن,0508351556,7,27,13,14,4,0508
نعل شکن,0508352076,14,58,30,28,4,0508
ورگچ,0508352081,4,10,4,6,4,0508
خوا خولگه,0508352083,0,0,0,0,4,0508
شرف آباد,0508352085,0,0,0,0,4,0508
دارماهي,0508352087,5,18,7,11,4,0508
پاسگاه نيروي انتظامي گيسکه,0508353056,0,0,0,0,4,0508
پاسگاه انتظامي کاني شيخ,0508353057,0,0,0,0,4,0508
پاسگاه نيروي مرزي بازرگان,0508353058,0,0,0,0,4,0508
پاسگاه انتظامي تلخاب,0508353059,0,0,0,0,4,0508
پاسگاه ميان تنگ,0508353107,0,0,0,0,4,0508
پاسگاه انتظامي هفت دهنه,0508353110,0,0,0,0,4,0508
پله بيدسفلي,0504051977,18,55,29,26,4,0504
فولادي,0504051983,103,361,190,171,4,0504
کوسه ها,0504051984,35,126,66,60,4,0504
کوهالي,0504051985,49,218,121,97,4,0504
کوچاني,0504051986,80,242,125,117,4,0504
محمد علي قره گه,0504051987,8,22,12,10,4,0504
مزرعه پله بيدعليا,0504051988,0,0,0,0,4,0504
پاطاق,0504051976,84,221,122,99,4,0504
تلمبه خانه پاطاق,0504051978,0,0,0,0,4,0504
رفيع,0504051982,116,439,235,204,4,0504
پل ماهيت,0504051945,85,286,156,130,4,0504
مهکي مهرمات,0504351120,50,159,75,84,4,0504
مهکي امين بيگ,0504351121,10,36,21,15,4,0504
برزلک,0504051975,27,91,41,50,4,0504
حبيب وند,0504051979,220,785,389,396,4,0504
داروند,0504051981,39,129,65,64,4,0504
ميان کبودقاسم,0504051990,22,59,29,30,4,0504
ايينه,0504051943,158,564,310,254,4,0504
بلوان,0504051944,60,202,96,106,4,0504
کلاه مال,0504051953,82,296,144,152,4,0504
جلالوندسفلي,0504051946,68,207,101,106,4,0504
جلالوندعليا,0504051947,71,225,123,102,4,0504
رضالک,0504051949,52,167,87,80,4,0504
چالکه,0504051948,79,256,126,130,4,0504
ريزوندعلي اکبر,0504051950,43,133,71,62,4,0504
ريزوندنجف,0504051951,58,201,103,98,4,0504
شرکت زراعي دالاهو,0504051952,0,0,0,0,4,0504
پاسگاه راهنمايي و رانندگي,0504353161,0,0,0,0,4,0504
هيبت اله,0505052344,50,165,81,84,4,0505
چشمه چراغ,0505052356,9,27,10,17,4,0505
چنگره,0505052358,6,17,8,9,4,0505
حسن اباد,0505052534,6,15,5,10,4,0505
خوشيار,0505052541,59,180,93,87,4,0505
ده سليمان,0505052547,81,222,105,117,4,0505
مزرعه مسلمانان,0505052591,0,0,0,0,4,0505
تاسيسات سد سليمانشاه,0505353162,0,0,0,0,4,0505
چهارگاه,0505052531,44,148,70,78,4,0505
حبشي,0505052533,49,140,72,68,4,0505
ده عباس,0505052549,26,89,40,49,4,0505
فيروزاباد,0505052568,30,99,53,46,4,0505
قلعه جوق,0505052570,0,0,0,0,4,0505
قمام,0505052572,5,18,8,10,4,0505
کاظم اباد,0505052575,0,0,0,0,4,0505
کوزه گران,0505052581,9,44,23,21,4,0505
بشيراباد,0505052343,100,315,160,155,4,0505
سالاراباد,0505052351,105,327,160,167,4,0505
چم کبود,0505052353,100,325,168,157,4,0505
سردره قبادي,0505052376,39,120,60,60,4,0505
کيسله,0505052397,0,0,0,0,4,0505
مزرعه بيگلراباد,0505052401,0,0,0,0,4,0505
اسلاميه,0505052495,26,101,46,55,4,0505
اسياب جوب فرمانفرما,0505052498,17,58,32,26,4,0505
ده رضوان,0505052546,61,207,99,108,4,0505
گردکانه سفلي,0505052374,96,264,126,138,4,0505
پاييزاباد,0505052514,89,291,145,146,4,0505
کلک امجدي,0505052578,146,436,220,216,4,0505
گردکانه عليا,0505052375,259,752,367,385,4,0505
چشمه کره,0505052527,27,76,39,37,4,0505
مرزبان,0505052588,38,118,58,60,4,0505
چرکس,0505052520,11,32,20,12,4,0505
حسين ابادامجدي,0505052536,63,208,110,98,4,0505
کل کل,0505052577,50,156,78,78,4,0505
گرجي بيان,0505052583,118,337,173,164,4,0505
گرگين در,0505052584,20,60,34,26,4,0505
ميدان,0505052594,54,173,88,85,4,0505
سراب سورن اباد,0505052555,15,41,20,21,4,0505
سورن اباد,0505052561,72,207,97,110,4,0505
ميش رنگين حاجي قادر,0504351867,24,85,47,38,4,0504
ميش رنگين سلمان,0504351868,0,0,0,0,4,0504
ميل قادرسفلي,0504351869,29,113,58,55,4,0504
ميل قادرعليا,0504351870,31,110,57,53,4,0504
نعل بندگرجي,0504351871,5,20,8,12,4,0504
امام عباس سفلي,0504351872,0,0,0,0,4,0504
امام عباس عليا,0504351873,29,129,56,73,4,0504
تپه کبود,0504351875,35,146,72,74,4,0504
سرايي,0504351882,27,123,59,64,4,0504
سفيدسوار,0504351883,6,30,16,14,4,0504
سه تپان حبيب,0504351884,0,0,0,0,4,0504
سه تپان سليم,0504351885,5,21,11,10,4,0504
سه تپان عزيز,0504351886,22,103,52,51,4,0504
کاني شيرينه,0504351887,0,0,0,0,4,0504
گرده نو,0504351889,31,127,62,65,4,0504
تپه کبود سفلي,0504353177,26,111,60,51,4,0504
اينه وندداره رشته,0504351866,16,65,30,35,4,0504
دارتوت موالي,0504351874,24,85,47,38,4,0504
توه خشکه,0504351876,7,32,13,19,4,0504
چناره علي مدد,0504351877,21,93,45,48,4,0504
چناره لطيف,0504351878,17,73,36,37,4,0504
چناره مجيد,0504351879,21,109,55,54,4,0504
داره لار اسد,0504351880,29,101,48,53,4,0504
داره لارشريف,0504351881,0,0,0,0,4,0504
کيله سفيد,0504351888,17,59,28,31,4,0504
لايزکريم,0504351890,21,118,66,52,4,0504
مرادخاني سياره جگيران,0504351891,22,97,50,47,4,0504
آيينه وند عبداله,0504351892,18,76,38,38,4,0504
قشلاق,0505209259,141,420,208,212,4,0505
چماق تپه,0505209251,54,157,83,74,4,0505
ده اسياب,0505209252,40,116,65,51,4,0505
سرخليجه,0505209254,51,148,73,75,4,0505
طاهراباد,0505209255,177,561,295,266,4,0505
شريف اباد,0505209256,0,0,0,0,4,0505
آقبلاغ,0505209245,0,0,0,0,4,0505
تپه شارک,0505209246,0,0,0,0,4,0505
جعفراباد,0505209247,91,290,132,158,4,0505
چم چم,0505209248,82,231,125,106,4,0505
چغا بالا سفلي,0505209249,53,148,77,71,4,0505
چغا بالا عليا,0505209250,0,0,0,0,4,0505
زيوه,0505209253,18,55,30,25,4,0505
عظيم اباد,0505209257,27,85,40,45,4,0505
چشمه سنگي,0505209260,15,41,22,19,4,0505
کهتر,0505209261,24,73,29,44,4,0505
کهريز,0505209262,0,0,0,0,4,0505
ملک اباد,0505209263,10,35,22,13,4,0505
باويسي ماشيان,0504351900,6,29,15,14,4,0504
تازه ابادباويسي,0504351901,0,0,0,0,4,0504
تازه ابادسلمانه,0504351902,0,0,0,0,4,0504
تپه درويش,0504351903,0,0,0,0,4,0504
تپه رش,0504351904,16,58,27,31,4,0504
تپه کنعان,0504351905,25,106,53,53,4,0504
تپه نوروز,0504351906,0,0,0,0,4,0504
توه خشکه,0504351907,0,0,0,0,4,0504
تيله کوه,0504351908,11,49,18,31,4,0504
چفته سفلي,0504351909,0,0,0,0,4,0504
چفته عليا,0504351910,0,0,0,0,4,0504
دربندزردسفلي,0504351911,11,49,27,22,4,0504
دربندزردعليا,0504351912,8,28,15,13,4,0504
درويشي,0504351913,0,0,0,0,4,0504
رويله حسن,0504351914,0,0,0,0,4,0504
رويله سفلي,0504351915,0,0,0,0,4,0504
سيورهوار,0504351916,20,76,36,40,4,0504
شيخ روزين سفلي,0504351917,0,0,0,0,4,0504
شيخ روزين عليا,0504351918,0,0,0,0,4,0504
قلقله تازه اباد,0504351919,0,0,0,0,4,0504
کوزه رود,0504351920,17,57,24,33,4,0504
هوان,0504351921,10,36,15,21,4,0504
رويله,0504351922,0,0,0,0,4,0504
مزرعه ميان قپي ترشاب,0504351923,0,0,0,0,4,0504
باويسي سيدمحمد,0504351924,0,0,0,0,4,0504
پشت هيلکه,0504351925,0,0,0,0,4,0504
پله فيروزه,0504351926,0,0,0,0,4,0504
تيله کوه مياني,0504353132,0,0,0,0,4,0504
سلمانه,0504359999,0,0,0,0,4,0504
شمشير,0503051793,639,2222,1130,1092,4,0503
چوريژي,0503051784,833,2717,1344,1373,4,0503
دوريسان,0503051791,1042,3500,1728,1772,4,0503
سهنله,0505052377,377,1224,617,607,4,0505
ده کهنه,0507208539,159,510,232,278,4,0507
دهلر,0507208542,292,1023,550,473,4,0507
کل کش,0508053253,508,1622,784,838,4,0508
سنقراباد,0511047929,534,1929,929,1000,4,0511
بلوردي جديد,0511047889,638,2188,1082,1106,4,0511
چشمه کبود,0511050353,370,1367,651,716,4,0511
چقاکبود,0501047123,399,1288,611,677,4,0501
برف ابادعليا,0501047102,527,1792,903,889,4,0501
سرباغ گلين,0504053305,430,1397,699,698,4,0504
فش,0507053030,507,1545,777,768,4,0507
چهر,0511050359,664,2277,1136,1141,4,0511
سرماج حسين خاني,0511050371,347,1150,564,586,4,0511
تمرک,0511050346,412,1478,707,771,4,0511
کندهر,0501047723,313,1089,533,556,4,0501
ده پهن,0502049156,1887,6548,3187,3361,4,0502
خانقاه,0503051785,424,1305,657,648,4,0503
دشه,0503051790,476,1549,766,783,4,0503
باوله,0505052380,281,1080,509,571,4,0505
زيلان,0509050881,439,1557,777,780,4,0509
کندوله,0510048234,161,522,242,280,4,0510
بيدسرخ,0510048334,230,705,360,345,4,0510
قارلق بزرگ,0507053034,602,2000,957,1043,4,0507
کارخانه,0507053047,510,1647,801,846,4,0507
علي گرزان عليا,0510047948,164,559,264,295,4,0510
الهيه,0510048332,456,1541,759,782,4,0510
قلعه شيان,0501047527,586,1923,981,942,4,0501
گاوبنده,0502049170,691,2403,1144,1259,4,0502
قزانچي,0502050118,793,2755,1346,1409,4,0502
فارسينج جديد,0505209258,639,2004,1009,995,4,0505
